Id,Label,timeset,indegree,outdegree,degree,modularity_class,clustering,eigencentrality,weighted indegree,weighted outdegree,weighted degree,Eccentricity,closnesscentrality,harmonicclosnesscentrality,betweenesscentrality,componentnumber,pageranks
n1,README,,1,2,3,95,0.166667,0.000378,1,4,5,5,0.270846,0.291049,597.673223,0,0.000284
n2,bin/p6doc,,5,11,16,95,0.1,0.00155,9,18,27,4,0.344597,0.368111,13424.472615,0,0.001236
n3,lib/Any.pod,,2,34,36,1,0.378571,0.003629,2,46,48,5,0.265919,0.297434,10499.08658,0,0.001526
n4,lib/Str.pod,,30,7,37,1,0.370871,0.003685,50,10,60,6,0.220463,0.253516,59.913243,0,0.001532
n5,CREDITS,,0,3,3,136,0.5,0.012641,0,3,3,8,0.264555,0.311815,0,0,0.000174
n6,lib/Pod/To/SectionFilter.pm,,8,0,8,95,0.339286,0.000957,9,0,9,5,0.331444,0.349373,30.772222,0,0.000611
n7,lib/List.pod,,15,21,36,1,0.388095,0.003625,22,36,58,6,0.220407,0.252946,48.052434,0,0.001479
n8,LICENSE,,0,52,52,95,0.480769,0.011302,0,52,52,5,0.34514,0.386336,911.704716,0,0.001458
n9,lib/Pair.pod,,13,11,24,1,0.376812,0.002376,18,13,31,6,0.218922,0.244394,33.999517,0,0.001067
n10,lib/Enum.pod,,5,11,16,1,0.5,0.001661,7,12,19,6,0.218322,0.239453,0,0,0.000734
n11,lib/Buf.pod,,2,32,34,1,0.424242,0.003498,4,45,49,6,0.220296,0.251805,13.397975,0,0.001381
n12,lib/Bool.pod,,1,15,16,1,0.5,0.001661,1,20,21,6,0.218322,0.239453,0,0,0.000734
n13,lib/Int.pm,,6,10,16,1,0.5,0.001661,6,10,16,6,0.218322,0.239453,0,0,0.000734
n14,lib/Mu.pod,,17,20,37,1,0.361862,0.003695,24,30,54,5,0.272954,0.303668,16782.30502,0,0.00155
n15,lib/Range.pod,,21,13,34,1,0.424242,0.003498,28,17,45,6,0.220296,0.251805,13.397975,0,0.001381
n16,lib/Code.pod,,3,13,16,1,0.5,0.001661,4,13,17,6,0.218322,0.239453,0,0,0.000734
n17,lib/perlvar.pod,,0,0,0,0,0,0,0,0,0,0,0,0,0,0,0
n18,lib/Numeric.pod,,17,17,34,1,0.424242,0.003498,25,22,47,6,0.220296,0.251805,13.397975,0,0.001381
n19,lib/Real.pod,,24,10,34,1,0.424242,0.003498,34,11,45,6,0.220296,0.251805,13.397975,0,0.001381
n20,lib/Rat.pod,,22,12,34,1,0.424242,0.003498,30,15,45,6,0.220296,0.251805,13.397975,0,0.001381
n21,lib/Rational.pod,,23,11,34,1,0.424242,0.003498,32,13,45,6,0.220296,0.251805,13.397975,0,0.001381
n22,lib/Match.pod,,16,19,35,1,0.404202,0.003558,21,30,51,6,0.220352,0.252376,24.258783,0,0.001434
n23,lib/Cool.pod,,7,31,38,1,0.347795,0.003755,9,46,55,6,0.238575,0.275238,1629.975093,0,0.001689
n24,htmlify.pl,,3,20,23,95,0.06917,0.001781,8,38,46,5,0.297692,0.328563,14701.824564,0,0.002438
n25,lib/Pod/To/Serialization.pm,,0,0,0,2,0,0,0,0,0,0,0,0,0,0,0
n26,lib/Array.pod,,0,0,0,3,0,0,0,0,0,0,0,0,0,0,0
n27,lib/Stringy.pod,,0,0,0,4,0,0,0,0,0,0,0,0,0,0,0
n28,lib/Callable.pod,,0,0,0,5,0,0,0,0,0,0,0,0,0,0,0
n29,lib/operators.pod,,31,2,33,1,0.414773,0.003399,35,3,38,6,0.23825,0.272387,1495.922966,0,0.001412
n30,lib/glossary.pod,,26,4,30,1,0.466667,0.003163,26,4,30,6,0.220573,0.251235,8670,0,0.001276
n31,lib/Positional.pod,,1,0,1,80,0,0.00009,1,0,1,6,0.264955,0.275124,0,0,0.000219
n32,.gitignore,,0,18,18,95,0.120915,0.004089,0,21,21,5,0.364657,0.388046,8237.35479,0,0.001219
n33,sync,,0,0,0,6,0,0,0,0,0,0,0,0,0,0,0
n34,index.pl,,2,3,5,1,0.3,0.000444,3,3,6,5,0.264236,0.281623,197.129112,0,0.000477
n35,lib/variables.pod,,33,0,33,1,0.411932,0.003372,40,0,40,6,0.258855,0.285842,5978.650301,0,0.001425
n36,lib/Exception.pod,,1,5,6,1,0.5,0.000649,1,5,6,6,0.216543,0.231775,0,0,0.000374
n37,lib/IO.pod,,0,4,4,95,0.25,0.000436,0,4,4,5,0.324815,0.336811,6543.724576,0,0.000485
n38,lib/Int.pod,,10,21,31,1,0.437634,0.003209,11,22,33,6,0.220296,0.250665,4360,0,0.001512
n39,TODO,,0,21,21,80,0.147619,0.002883,0,23,23,5,0.360312,0.388236,3228.036079,0,0.001501
n40,lib/X/AdHoc.pod,,0,0,0,7,0,0,0,0,0,0,0,0,0,0,0
n41,lib/Parcel.pod,,15,14,29,1,0.5,0.0031,15,14,29,6,0.22002,0.248955,0,0,0.001188
n42,lib/Signature.pod,,24,7,31,1,0.45914,0.00325,27,8,35,6,0.220131,0.250095,11.707867,0,0.001278
n43,lib/Backtrace/Frame.pod,,0,0,0,8,0,0,0,0,0,0,0,0,0,0,0
n44,lib/Instant.pod,,0,8,8,1,0.5,0.000813,0,8,8,7,0.211836,0.227605,0,0,0.000461
n45,lib/Duration.pod,,6,23,29,1,0.5,0.0031,6,23,29,6,0.22002,0.248955,0,0,0.001188
n46,lib/Backtrace.pod,,1,0,1,80,0,0.00009,1,0,1,6,0.264955,0.275124,0,0,0.000219
n47,lib/Complex.pod,,2,27,29,1,0.5,0.0031,2,27,29,6,0.22002,0.248955,0,0,0.001188
n48,lib/objects.pod,,32,3,35,1,0.372269,0.003513,37,6,43,6,0.23838,0.273527,1555.98907,0,0.001578
n49,lib/EnumMap.pod,,0,0,0,9,0,0,0,0,0,0,0,0,0,0,0
n50,lib/Hash.pod,,8,21,29,1,0.5,0.0031,8,21,29,6,0.22002,0.248955,0,0,0.001188
n51,search_template.html,,1,0,1,95,0,0.000085,1,0,1,6,0.229461,0.241391,0,0,0.000248
n52,html/css/custom-theme/jquery-ui-1.8.21.custom.css,,0,2,2,10,0.5,0.000107,0,2,2,1,1,1,0,1,0.001053
n53,html/js/jquery-1.7.2.min.js,,1,1,2,10,0.5,0.000107,1,1,2,1,1,1,0,1,0.001053
n54,html/js/jquery-ui-1.8.21.custom.min.js,,2,0,2,10,0.5,0.000107,2,0,2,1,1,1,0,1,0.001053
n55,lib/Parameter.pod,,14,15,29,1,0.5,0.0031,14,15,29,6,0.22002,0.248955,0,0,0.001188
n56,type-graph.txt,,47,4,51,95,0.046667,0.020231,50,4,54,5,0.452528,0.488578,96731.460007,0,0.002788
n57,lib/Perl6/TypeGraph.pm,,6,4,10,95,0.266667,0.001317,10,10,20,4,0.351926,0.371722,10713.603052,0,0.000663
n58,t/typegraph.t,,11,13,24,144,0.257246,0.003621,15,13,28,5,0.3615,0.387761,3633.702244,0,0.001198
n59,lib/Perl6/Type.pm,,4,4,8,95,0.375,0.001111,4,8,12,5,0.342444,0.360015,51.363088,0,0.000579
n60,util/check-type-graph.pl6,,6,2,8,95,0.375,0.001074,6,3,9,5,0.343652,0.362676,55.074215,0,0.000569
n61,lib/Date.pod,,5,24,29,1,0.5,0.0031,5,24,29,6,0.22002,0.248955,0,0,0.001188
n62,lib/Associative.pod,,0,0,0,11,0,0,0,0,0,0,0,0,0,0,0
n63,lib/X/Comp.pod,,0,5,5,26,0.5,0.000286,0,5,5,1,1,1,0,2,0.001053
n64,lib/Junction.pod,,1,0,1,80,0,0.00009,1,0,1,6,0.264955,0.275124,0,0,0.000219
n65,util/missing-types.pl6,,7,1,8,95,0.375,0.001074,8,1,9,5,0.343652,0.362676,55.074215,0,0.000569
n66,lib/Num.pod,,0,0,0,12,0,0,0,0,0,0,0,0,0,0,0
n67,lib/Version.pod,,5,3,8,1,0.5,0.000813,5,3,8,7,0.211836,0.227605,0,0,0.000461
n68,lib/Grammar.pod,,7,22,29,1,0.5,0.0031,7,22,29,6,0.22002,0.248955,0,0,0.001188
n69,lib/Cursor.pod,,4,25,29,1,0.5,0.0031,4,25,29,6,0.22002,0.248955,0,0,0.001188
n70,lib/Whatever.pod,,0,0,0,13,0,0,0,0,0,0,0,0,0,0,0
n71,lib/Block.pod,,0,0,0,14,0,0,0,0,0,0,0,0,0,0,0
n72,lib/WhateverCode.pod,,0,0,0,15,0,0,0,0,0,0,0,0,0,0,0
n73,lib/Perl6/TypeGraph/Viz.pm,,8,2,10,95,0.233333,0.001208,14,2,16,4,0.341777,0.36279,8018.038051,0,0.000702
n74,lib/AST.pod,,0,0,0,16,0,0,0,0,0,0,0,0,0,0,0
n75,lib/Routine.pod,,23,9,32,1,0.438508,0.003316,24,13,37,6,0.220186,0.250665,33.634852,0,0.001323
n76,lib/X/Syntax.pod,,0,0,0,17,0,0,0,0,0,0,0,0,0,0,0
n77,lib/X/Syntax/NegatedPair.pod,,0,0,0,18,0,0,0,0,0,0,0,0,0,0,0
n78,lib/Iterable.pod,,0,1,1,19,0,0.000052,0,1,1,1,1,1,0,3,0.001053
n79,lib/Iterator.pod,,1,0,1,19,0,0.000052,1,0,1,1,1,1,0,3,0.001053
n80,lib/Capture.pod,,0,0,0,20,0,0,0,0,0,0,0,0,0,0,0
n81,lib/Attribute.pod,,0,0,0,21,0,0,0,0,0,0,0,0,0,0,0
n82,lib/FatRat.pod,,0,0,0,22,0,0,0,0,0,0,0,0,0,0,0
n83,lib/Failure.pod,,0,0,0,23,0,0,0,0,0,0,0,0,0,0,0
n84,lib/Perl6/Documentable.pm,,53,5,58,95,0.391712,0.011751,65,7,72,5,0.349542,0.394128,5895.741023,0,0.001835
n85,lib/Perl6/Documentable/Registry.pm,,5,5,10,95,0.244444,0.001112,12,6,18,5,0.335758,0.355264,479.151731,0,0.000772
n86,lib/X/IO.pod,,0,4,4,24,0.5,0.000224,0,4,4,1,1,1,0,4,0.001053
n87,lib/X/IO/Copy.pod,,1,3,4,24,0.5,0.000224,1,3,4,1,1,1,0,4,0.001053
n88,lib/X/IO/Mkdir.pod,,2,2,4,24,0.5,0.000224,2,2,4,1,1,1,0,4,0.001053
n89,lib/X/IO/Rename.pod,,3,1,4,24,0.5,0.000224,3,1,4,1,1,1,0,4,0.001053
n90,lib/X/OS.pod,,4,0,4,24,0.5,0.000224,4,0,4,1,1,1,0,4,0.001053
n91,lib/X/IO/Chdir.pod,,0,2,2,25,0.5,0.000107,0,2,2,1,1,1,0,5,0.001053
n92,lib/X/IO/Cwd.pod,,1,1,2,25,0.5,0.000107,1,1,2,1,1,1,0,5,0.001053
n93,lib/X/IO/Dir.pod,,2,0,2,25,0.5,0.000107,2,0,2,1,1,1,0,5,0.001053
n94,META.info,,1,3,4,95,0.083333,0.000708,1,4,5,5,0.299624,0.314101,90.039406,0,0.000371
n95,lib/X/IO/Chmod.pod,,1,4,5,26,0.5,0.000286,1,4,5,1,1,1,0,2,0.001053
n96,lib/X/IO/Rmdir.pod,,2,3,5,26,0.5,0.000286,2,3,5,1,1,1,0,2,0.001053
n97,lib/X/IO/Unlink.pod,,3,2,5,26,0.5,0.000286,3,2,5,1,1,1,0,2,0.001053
n98,lib/X/NYI.pod,,4,1,5,26,0.5,0.000286,4,1,5,1,1,1,0,2,0.001053
n99,lib/X/Placeholder/Block.pod,,5,0,5,26,0.5,0.000286,5,0,5,1,1,1,0,2,0.001053
n100,lib/ObjAt.pod,,0,0,0,27,0,0,0,0,0,0,0,0,0,0,0
n101,lib/X/Placeholder/Mainline.pod,,7,3,10,1,0.4,0.00067,7,3,10,7,0.181423,0.199995,7812,0,0.001058
n102,lib/X/Attribute/Undeclared.pod,,0,9,9,1,0.5,0.000568,0,9,9,8,0.153806,0.167087,0,0,0.001016
n103,lib/X/Parameter/Default.pod,,1,8,9,1,0.5,0.000568,1,8,9,8,0.153806,0.167087,0,0,0.001016
n104,lib/X/Parameter/MultipleTypeConstraints.pod,,2,7,9,1,0.5,0.000568,2,7,9,8,0.153806,0.167087,0,0,0.001016
n105,lib/X/Parameter/Placeholder.pod,,3,6,9,1,0.5,0.000568,3,6,9,8,0.153806,0.167087,0,0,0.001016
n106,lib/X/Parameter/Twigil.pod,,4,5,9,1,0.5,0.000568,4,5,9,8,0.153806,0.167087,0,0,0.001016
n107,lib/X/Parameter/WrongOrder.pod,,5,4,9,1,0.5,0.000568,5,4,9,8,0.153806,0.167087,0,0,0.001016
n108,lib/X/Phaser/Multiple.pod,,6,3,9,1,0.5,0.000568,6,3,9,8,0.153806,0.167087,0,0,0.001016
n109,lib/X/Redeclaration.pod,,8,1,9,1,0.5,0.000568,8,1,9,8,0.153806,0.167087,0,0,0.001016
n110,lib/X/Undeclared.pod,,9,0,9,1,0.5,0.000568,9,0,9,8,0.153806,0.167087,0,0,0.001016
n111,lib/X/Signature/NameClash.pod,,0,0,0,28,0,0,0,0,0,0,0,0,0,0,0
n112,lib/X/Method/Private/Permission.pod,,1,0,1,95,0,0.000085,1,0,1,6,0.229461,0.241391,0,0,0.000248
n113,lib/X/Method/Private/Unqualified.pod,,0,0,0,29,0,0,0,0,0,0,0,0,0,0,0
n114,lib/X/Bind/NativeType.pod,,0,0,0,30,0,0,0,0,0,0,0,0,0,0,0
n115,lib/X/Attribute/Package.pod,,1,0,1,31,0,0.000052,1,0,1,1,1,1,0,6,0.001053
n116,lib/X/Attribute/NoPackage.pod,,0,1,1,31,0,0.000052,0,1,1,1,1,1,0,6,0.001053
n117,lib/X/Anon/Augment.pod,,0,2,2,32,0.5,0.000107,0,2,2,1,1,1,0,7,0.001053
n118,lib/X/Anon/Multi.pod,,1,1,2,32,0.5,0.000107,1,1,2,1,1,1,0,7,0.001053
n119,lib/X/Augment/NoSuchType.pod,,2,0,2,32,0.5,0.000107,2,0,2,1,1,1,0,7,0.001053
n120,lib/X/TypeCheck.pod,,0,3,3,33,0.5,0.000164,0,3,3,1,1,1,0,8,0.001053
n121,lib/X/TypeCheck/Assignment.pod,,1,2,3,33,0.5,0.000164,1,2,3,1,1,1,0,8,0.001053
n122,lib/X/TypeCheck/Binding.pod,,2,1,3,33,0.5,0.000164,2,1,3,1,1,1,0,8,0.001053
n123,lib/X/TypeCheck/Return.pod,,3,0,3,33,0.5,0.000164,3,0,3,1,1,1,0,8,0.001053
n124,lib/X/Pod.pod,,0,3,3,34,0.5,0.000164,0,3,3,1,1,1,0,9,0.001053
n125,lib/X/Syntax/Confused.pod,,1,2,3,34,0.5,0.000164,1,2,3,1,1,1,0,9,0.001053
n126,lib/X/Syntax/InfixInTermPosition.pod,,2,1,3,34,0.5,0.000164,2,1,3,1,1,1,0,9,0.001053
n127,lib/X/Syntax/Placeholder.pod,,3,0,3,34,0.5,0.000164,3,0,3,1,1,1,0,9,0.001053
n128,lib/X/Syntax/Missing.pod,,0,1,1,35,0,0.000052,0,1,1,1,1,1,0,10,0.001053
n129,lib/X/Syntax/NoSelf.pod,,1,0,1,35,0,0.000052,1,0,1,1,1,1,0,10,0.001053
n130,lib/X/Role/Initialization.pod,,0,0,0,36,0,0,0,0,0,0,0,0,0,0,0
n131,lib/X/Method/InvalidQualifier.pod,,0,0,0,37,0,0,0,0,0,0,0,0,0,0,0
n132,lib/X/Syntax/Number/RadixOutOfRange.pod,,0,0,0,38,0,0,0,0,0,0,0,0,0,0,0
n133,lib/X/Export/NameClash.pod,,0,0,0,39,0,0,0,0,0,0,0,0,0,0,0
n134,lib/X/Sequence/Deduction.pod,,0,0,0,40,0,0,0,0,0,0,0,0,0,0,0
n135,lib/X/Composition/NotComposable.pod,,0,0,0,41,0,0,0,0,0,0,0,0,0,0,0
n136,lib/X/Numeric/Real.pod,,0,0,0,42,0,0,0,0,0,0,0,0,0,0,0
n137,lib/X/Phaser/PrePost.pod,,0,0,0,43,0,0,0,0,0,0,0,0,0,0,0
n138,lib/X/Package/Stubbed.pod,,0,0,0,44,0,0,0,0,0,0,0,0,0,0,0
n139,lib/X/Inheritance/Unsupported.pod,,0,0,0,45,0,0,0,0,0,0,0,0,0,0,0
n140,lib/X/Declaration/Scope.pod,,0,0,0,46,0,0,0,0,0,0,0,0,0,0,0
n141,lib/X/Syntax/Augment/Role.pod,,0,1,1,47,0,0.000052,0,1,1,1,1,1,0,11,0.001053
n142,lib/X/Syntax/Augment/WithoutMonkeyTyping.pod,,1,0,1,47,0,0.000052,1,0,1,1,1,1,0,11,0.001053
n143,lib/X/Temporal.pod,,0,1,1,48,0,0.000052,0,1,1,1,1,1,0,12,0.001053
n144,lib/X/Temporal/Truncation.pod,,1,0,1,48,0,0.000052,1,0,1,1,1,1,0,12,0.001053
n145,lib/X/ControlFlow.pod,,0,1,1,49,0,0.000052,0,1,1,1,1,1,0,13,0.001053
n146,lib/X/ControlFlow/Return.pod,,1,0,1,49,0,0.000052,1,0,1,1,1,1,0,13,0.001053
n147,lib/X/Method/NotFound.pod,,0,0,0,50,0,0,0,0,0,0,0,0,0,0,0
n148,lib/X/Str/Numeric.pod,,0,0,0,51,0,0,0,0,0,0,0,0,0,0,0
n149,lib/X/OutOfRange.pod,,0,0,0,52,0,0,0,0,0,0,0,0,0,0,0
n150,lib/X/Syntax/UnlessElse.pod,,0,0,0,53,0,0,0,0,0,0,0,0,0,0,0
n151,lib/X/Syntax/Comment/Embedded.pod,,0,0,0,54,0,0,0,0,0,0,0,0,0,0,0
n152,lib/X/Syntax/Variable/Numeric.pod,,0,0,0,55,0,0,0,0,0,0,0,0,0,0,0
n153,lib/X/Syntax/Variable/Match.pod,,0,0,0,56,0,0,0,0,0,0,0,0,0,0,0
n154,lib/X/Syntax/Signature/InvocantMarker.pod,,0,0,0,57,0,0,0,0,0,0,0,0,0,0,0
n155,lib/Regex.pod,,20,9,29,1,0.5,0.0031,20,9,29,6,0.22002,0.248955,0,0,0.001188
n156,lib/Nil.pod,,0,0,0,58,0,0,0,0,0,0,0,0,0,0,0
n157,lib/Sub.pod,,0,0,0,59,0,0,0,0,0,0,0,0,0,0,0
n158,lib/Method.pod,,0,0,0,60,0,0,0,0,0,0,0,0,0,0,0
n159,lib/X/Mixin/NotComposable.pod,,0,1,1,95,0,0.000217,0,1,1,6,0.311656,0.322976,0,0,0.000204
n160,lib/X/NoDispatcher.pod,,0,0,0,61,0,0,0,0,0,0,0,0,0,0,0
n161,lib/X/Declaration/Scope/Multi.pod,,0,0,0,62,0,0,0,0,0,0,0,0,0,0,0
n162,lib/X/Syntax/Variable/Twigil.pod,,0,0,0,63,0,0,0,0,0,0,0,0,0,0,0
n163,lib/X/Syntax/Self/WithoutObject.pod,,0,0,0,64,0,0,0,0,0,0,0,0,0,0,0
n164,lib/X/Syntax/P5.pod,,0,0,0,65,0,0,0,0,0,0,0,0,0,0,0
n165,lib/Macro.pod,,0,0,0,66,0,0,0,0,0,0,0,0,0,0,0
n166,lib/X/Syntax/Regex/Adverb.pod,,0,0,0,67,0,0,0,0,0,0,0,0,0,0,0
n167,lib/X/Syntax/Reserved.pod,,0,0,0,68,0,0,0,0,0,0,0,0,0,0,0
n168,lib/X/Constructor/Positional.pod,,0,0,0,69,0,0,0,0,0,0,0,0,0,0,0
n169,lib/X/Syntax/Obsolete.pod,,0,0,0,70,0,0,0,0,0,0,0,0,0,0,0
n170,lib/X/Eval/NoSuchLang.pod,,3,1,4,1,0.5,0.000369,3,1,4,6,0.233929,0.252261,0,0,0.000406
n171,lib/X/TypeCheck/MacroUnquote.pod,,0,0,0,71,0,0,0,0,0,0,0,0,0,0,0
n172,html/style.css,,0,7,7,95,0.357143,0.000502,0,22,22,5,0.264316,0.278278,103.586758,0,0.000802
n173,lib/X/TypeCheck/Splice.pod,,0,0,0,72,0,0,0,0,0,0,0,0,0,0,0
n174,lib/X/Signature/Placeholder.pod,,0,0,0,73,0,0,0,0,0,0,0,0,0,0,0
n175,lib/Pod/Block.pod,,0,4,4,74,0.5,0.000224,0,4,4,1,1,1,0,14,0.001053
n176,lib/Pod/Block/Code.pod,,1,3,4,74,0.5,0.000224,1,3,4,1,1,1,0,14,0.001053
n177,lib/Pod/Block/Named.pod,,2,2,4,74,0.5,0.000224,2,2,4,1,1,1,0,14,0.001053
n178,lib/Pod/Block/Para.pod,,3,1,4,74,0.5,0.000224,3,1,4,1,1,1,0,14,0.001053
n179,lib/Pod/Item.pod,,4,0,4,74,0.5,0.000224,4,0,4,1,1,1,0,14,0.001053
n180,lib/terms.pod,,28,1,29,1,0.5,0.0031,28,1,29,6,0.22002,0.248955,0,0,0.001188
n181,app.pl,,3,4,7,95,0.404762,0.001406,6,5,11,6,0.345276,0.363854,43.449293,0,0.000559
n182,lib/classtut.pod,,25,5,30,1,0.470115,0.003183,25,7,32,6,0.238056,0.270677,1166.840452,0,0.001277
n183,lib/containers.pod,,1,0,1,95,0,0.000085,1,0,1,6,0.229461,0.241391,0,0,0.000248
n184,html/search.html,,0,3,3,95,0.5,0.000196,0,5,5,6,0.229581,0.242531,0,0,0.000558
n185,search_template.js,,3,0,3,95,0.5,0.000196,6,0,6,6,0.229581,0.242531,0,0,0.000558
n186,index_head.html,,2,2,4,95,0.333333,0.000249,2,2,4,6,0.229641,0.243101,1,0,0.000707
n187,index_header.html,,3,0,3,95,0.333333,0.000202,3,0,3,6,0.229581,0.242531,0.5,0,0.000497
n188,template/footer.html,,17,3,20,95,0.147368,0.001702,36,13,49,5,0.337958,0.362581,3046.792949,0,0.001917
n189,template/head.html,,17,2,19,95,0.143275,0.001552,43,9,52,5,0.335245,0.35935,2247.319619,0,0.001878
n190,template/header.html,,13,1,14,95,0.225275,0.00132,43,3,46,5,0.334989,0.35707,783.008357,0,0.001209
n191,template/footer_template.html,,3,3,6,95,0.433333,0.000478,9,9,18,5,0.282175,0.297206,96.030521,0,0.000637
n192,template/search_template.js,,11,0,11,95,0.245455,0.001083,24,0,24,5,0.341511,0.35954,1192.329795,0,0.001057
n193,lib/Set.pod,,5,0,5,1,0.2,0.000322,9,0,9,7,0.180825,0.195624,2622,0,0.001013
n194,lib/Mix.pod,,0,3,3,1,0.5,0.000167,0,5,5,8,0.153215,0.161899,0,0,0.000768
n195,lib/MixHash.pod,,1,2,3,1,0.5,0.000167,2,3,5,8,0.153215,0.161899,0,0,0.000768
n196,lib/Mixy.pod,,2,1,3,1,0.5,0.000167,4,1,5,8,0.153215,0.161899,0,0,0.000768
n197,lib/Bag.pod,,0,2,2,1,0.5,0.000162,0,6,6,7,0.180713,0.193913,0,0,0.000372
n198,lib/QuantHash.pod,,0,0,0,75,0,0,0,0,0,0,0,0,0,0,0
n199,lib/BagHash.pod,,0,3,3,76,0.5,0.000164,0,3,3,1,1,1,0,15,0.001053
n200,lib/Baggy.pod,,1,2,3,76,0.5,0.000164,1,2,3,1,1,1,0,15,0.001053
n201,lib/SetHash.pod,,2,1,3,76,0.5,0.000164,2,1,3,1,1,1,0,15,0.001053
n202,lib/Setty.pod,,3,0,3,76,0.5,0.000164,3,0,3,1,1,1,0,15,0.001053
n203,WANTED,,0,13,13,80,0.166667,0.006229,0,14,14,7,0.24395,0.292491,55.736581,0,0.000423
n204,lib/regexes.pod,,0,0,0,77,0,0,0,0,0,0,0,0,0,0,0
n205,lib/IO/FileTestable.pod,,1,2,3,95,0.5,0.00033,1,2,3,5,0.317294,0.327936,0,0,0.000429
n206,lib/IO/Handle.pod,,2,1,3,95,0.5,0.00033,2,1,3,5,0.317294,0.327936,0,0,0.000429
n207,html/css/style.css,,8,22,30,95,0.154023,0.005008,39,45,84,6,0.367253,0.400342,5921.61125,0,0.001766
n208,lib/modules.pod,,0,0,0,78,0,0,0,0,0,0,0,0,0,0,0
n209,sketch/app.pl,,0,7,7,79,0.380952,0.000407,0,8,8,1,1,1,2.5,16,0.001277
n210,sketch/html/css/custom-theme/jquery-ui-1.8.21.custom.css,,1,5,6,79,0.5,0.000354,1,5,6,2,0.875,0.928571,0,16,0.00108
n211,sketch/html/css/style.css,,2,5,7,79,0.380952,0.000407,3,7,10,1,1,1,2.5,16,0.001277
n212,sketch/html/index.html,,3,3,6,79,0.5,0.000354,4,3,7,2,0.875,0.928571,0,16,0.00108
n213,sketch/html/js/jquery-1.7.2.min.js,,4,2,6,79,0.5,0.000354,4,2,6,2,0.875,0.928571,0,16,0.00108
n214,sketch/html/js/jquery-ui-1.8.21.custom.min.js,,5,1,6,79,0.5,0.000354,5,1,6,2,0.875,0.928571,0,16,0.00108
n215,sketch/html/js/search.js,,6,0,6,79,0.5,0.000354,6,0,6,2,0.875,0.928571,0,16,0.00108
n216,sketch/html/type.html,,2,0,2,79,0.5,0.00012,3,0,3,2,0.583333,0.642857,0,16,0.000468
n217,htmlify.p6,,80,43,123,95,0.112688,0.02443,106,102,208,5,0.472267,0.530388,97589.281403,0,0.005753
n218,template/index-content.html,,1,0,1,95,0,0.000334,1,0,1,6,0.320893,0.337134,0,0,0.000198
n219,html/index.html,,0,1,1,95,0,0.000334,0,1,1,6,0.320893,0.337134,0,0,0.000198
n220,lib/Type/Any.pod,,5,148,153,80,0.359391,0.118111,5,242,247,7,0.305256,0.412198,526.106968,0,0.001588
n221,lib/Type/Attribute.pod,,3,125,128,80,0.405819,0.104188,4,158,162,7,0.299624,0.394315,47.003222,0,0.001329
n222,lib/Type/Backtrace.pod,,4,125,129,80,0.40086,0.104599,6,158,164,7,0.299727,0.394885,52.576322,0,0.001339
n223,lib/Type/Backtrace/Frame.pod,,6,176,182,80,0.277973,0.126269,11,229,240,7,0.305468,0.425482,379.237166,0,0.001904
n224,lib/Type/Bag.pod,,5,106,111,80,0.466749,0.096645,5,111,116,6,0.303881,0.38759,352.519451,0,0.00121
n225,lib/Type/Baggy.pod,,8,159,167,80,0.300952,0.119971,11,195,206,6,0.310113,0.419897,1034.998029,0,0.001805
n226,lib/Type/Buf.pod,,10,118,128,80,0.405819,0.104188,14,147,161,7,0.299624,0.394315,47.003222,0,0.001329
n227,lib/Type/Capture.pod,,18,171,189,80,0.262158,0.127984,27,235,262,7,0.308152,0.431943,1816.80262,0,0.002164
n228,lib/Type/Code.pod,,12,116,128,80,0.405819,0.104188,18,143,161,7,0.299624,0.394315,47.003222,0,0.001329
n229,lib/Type/Complex.pod,,13,115,128,80,0.405819,0.104188,20,141,161,7,0.299624,0.394315,47.003222,0,0.001329
n230,lib/Type/Date.pod,,18,116,134,80,0.381326,0.106795,27,151,178,7,0.300342,0.397926,136.141495,0,0.001407
n231,lib/Type/Enum.pod,,18,110,128,80,0.405819,0.104188,27,134,161,7,0.299624,0.394315,47.003222,0,0.001329
n232,lib/Type/EnumMap.pod,,20,112,132,80,0.391279,0.106264,32,144,176,7,0.300034,0.396596,59.8931,0,0.001369
n233,lib/Type/Exception.pod,,20,108,128,80,0.405819,0.104188,31,131,162,7,0.299624,0.394315,47.003222,0,0.001329
n234,lib/Type/Failure.pod,,21,107,128,80,0.405819,0.104188,34,128,162,7,0.299624,0.394315,47.003222,0,0.001329
n235,lib/Type/Grammar.pod,,23,142,165,80,0.309719,0.120273,26,157,183,7,0.305468,0.41807,403.073436,0,0.001741
n236,lib/Type/Hash.pod,,24,104,128,80,0.405819,0.104188,37,124,161,7,0.299624,0.394315,47.003222,0,0.001329
n237,lib/Type/IO.pod,,27,143,170,80,0.293909,0.121199,34,172,206,6,0.367561,0.465241,10430.147933,0,0.001897
n238,lib/Type/IO/FileTestable.pod,,21,111,132,80,0.431529,0.110419,23,172,195,7,0.302831,0.399845,47.206475,0,0.001345
n239,lib/Type/IO/Handle.pod,,29,102,131,80,0.391544,0.105087,46,124,170,6,0.360016,0.441619,8627.350235,0,0.00143
n240,lib/Type/Int.pod,,34,101,135,80,0.37435,0.106526,52,129,181,7,0.302622,0.401442,433.657159,0,0.001518
n241,lib/Type/Iterator.pod,,32,99,131,80,0.390253,0.105098,48,117,165,7,0.299932,0.396025,210.034157,0,0.001394
n242,lib/Type/List.pod,,44,97,141,80,0.344529,0.1071,66,114,180,6,0.310883,0.40973,1738.075561,0,0.001679
n243,lib/Type/Match.pod,,37,96,133,80,0.389098,0.106875,59,118,177,7,0.301582,0.399161,80.965708,0,0.001382
n244,lib/Type/Mix.pod,,26,85,111,80,0.466749,0.096645,28,88,116,6,0.303881,0.38759,352.519451,0,0.00121
n245,lib/Type/Mixy.pod,,52,115,167,80,0.300952,0.119971,65,141,206,6,0.310113,0.419897,1034.998029,0,0.001805
n246,lib/Type/Mu.pod,,42,110,152,80,0.364021,0.118008,63,183,246,7,0.305043,0.411438,369.037963,0,0.00156
n247,lib/Type/Nil.pod,,64,118,182,80,0.277973,0.126269,90,145,235,7,0.305468,0.425482,379.237166,0,0.001904
n248,lib/Type/Numeric.pod,,52,111,163,80,0.314853,0.119557,61,123,184,7,0.303355,0.414459,242.377141,0,0.001696
n249,lib/Type/Pair.pod,,52,85,137,80,0.362119,0.106087,75,99,174,6,0.310333,0.40726,1079.113409,0,0.001586
n250,lib/Type/Parameter.pod,,69,113,182,80,0.277973,0.126269,99,138,237,7,0.305468,0.425482,379.237166,0,0.001904
n251,lib/Type/Pod/Block.pod,,71,111,182,80,0.277973,0.126269,103,132,235,7,0.305468,0.425482,379.237166,0,0.001904
n252,lib/Type/Pod/Block/Code.pod,,72,110,182,80,0.277973,0.126269,106,129,235,7,0.305468,0.425482,379.237166,0,0.001904
n253,lib/Type/Pod/Block/Named.pod,,73,109,182,80,0.277973,0.126269,109,126,235,7,0.305468,0.425482,379.237166,0,0.001904
n254,lib/Type/Pod/Item.pod,,75,107,182,80,0.277973,0.126269,114,121,235,7,0.305468,0.425482,379.237166,0,0.001904
n255,lib/Type/Positional.pod,,61,103,164,80,0.3112,0.119687,80,118,198,7,0.305468,0.417595,370.829105,0,0.001729
n256,lib/Type/Range.pod,,56,76,132,80,0.391279,0.106264,88,88,176,7,0.300034,0.396596,59.8931,0,0.001369
n257,lib/Type/Rational.pod,,68,95,163,80,0.314853,0.119557,91,108,199,7,0.303355,0.414459,242.377141,0,0.001696
n258,lib/Type/Real.pod,,69,94,163,80,0.314853,0.119557,93,104,197,7,0.303355,0.414459,242.377141,0,0.001696
n259,lib/Type/Regex.pod,,58,70,128,80,0.405819,0.104188,86,75,161,7,0.299624,0.394315,47.003222,0,0.001329
n260,lib/Type/Routine.pod,,60,69,129,80,0.399709,0.104281,91,73,164,7,0.300034,0.395455,84.411363,0,0.001373
n261,lib/Type/Set.pod,,44,67,111,80,0.466749,0.096645,48,68,116,6,0.303881,0.38759,352.519451,0,0.00121
n262,lib/Type/Setty.pod,,78,89,167,80,0.300952,0.119971,109,97,206,6,0.310113,0.419897,1034.998029,0,0.001805
n263,lib/Type/Signature.pod,,66,68,134,80,0.379811,0.106686,104,76,180,6,0.370355,0.45591,15758.484159,0,0.001453
n264,lib/Type/Str.pod,,68,69,137,80,0.365017,0.107024,109,75,184,7,0.302205,0.401537,532.482383,0,0.001555
n265,lib/Type/Version.pod,,67,65,132,80,0.391279,0.106264,107,69,176,7,0.300034,0.396596,59.8931,0,0.001369
n266,lib/Type/Whatever.pod,,101,81,182,80,0.277973,0.126269,153,82,235,7,0.305468,0.425482,379.237166,0,0.001904
n267,lib/Type/X/AdHoc.pod,,50,81,131,80,0.436113,0.110051,53,139,192,7,0.302727,0.399275,35.517691,0,0.001334
n268,lib/Type/X/Anon/Augment.pod,,51,80,131,80,0.436113,0.110051,55,140,195,7,0.302727,0.399275,35.517691,0,0.001334
n269,lib/Type/X/Anon/Multi.pod,,52,79,131,80,0.436113,0.110051,57,135,192,7,0.302727,0.399275,35.517691,0,0.001334
n270,lib/Type/X/Attribute/NoPackage.pod,,53,78,131,80,0.436113,0.110051,59,133,192,7,0.302727,0.399275,35.517691,0,0.001334
n271,lib/Type/X/Attribute/Package.pod,,54,77,131,80,0.436113,0.110051,61,131,192,7,0.302727,0.399275,35.517691,0,0.001334
n272,lib/Type/X/Attribute/Undeclared.pod,,55,76,131,80,0.436113,0.110051,63,129,192,7,0.302727,0.399275,35.517691,0,0.001334
n273,lib/Type/X/Augment/NoSuchType.pod,,58,75,133,80,0.424129,0.110326,70,132,202,7,0.302936,0.400415,73.606007,0,0.001388
n274,lib/Type/X/Bind/NativeType.pod,,57,74,131,80,0.436113,0.110051,67,125,192,7,0.302727,0.399275,35.517691,0,0.001334
n275,lib/Type/X/Comp.pod,,56,52,108,80,0.492385,0.096638,58,57,115,7,0.29749,0.382722,4.236827,0,0.001113
n276,lib/Type/X/Composition/NotComposable.pod,,59,72,131,80,0.436113,0.110051,70,122,192,7,0.302727,0.399275,35.517691,0,0.001334
n277,lib/Type/X/ControlFlow.pod,,61,70,131,80,0.436113,0.110051,74,123,197,7,0.302727,0.399275,35.517691,0,0.001334
n278,lib/Type/X/Declaration/Scope.pod,,63,68,131,80,0.436113,0.110051,76,116,192,7,0.302727,0.399275,35.517691,0,0.001334
n279,lib/Type/X/Eval/NoSuchLang.pod,,65,66,131,80,0.436113,0.110051,79,113,192,7,0.302727,0.399275,35.517691,0,0.001334
n280,lib/Type/X/Export/NameClash.pod,,66,65,131,80,0.436113,0.110051,81,111,192,7,0.302727,0.399275,35.517691,0,0.001334
n281,lib/Type/X/IO/Chdir.pod,,67,64,131,80,0.436113,0.110051,83,109,192,7,0.302727,0.399275,35.517691,0,0.001334
n282,lib/Type/X/IO/Copy.pod,,69,62,131,80,0.436113,0.110051,86,106,192,7,0.302727,0.399275,35.517691,0,0.001334
n283,lib/Type/X/IO/Dir.pod,,71,60,131,80,0.436113,0.110051,89,103,192,7,0.302727,0.399275,35.517691,0,0.001334
n284,lib/Type/X/IO/Mkdir.pod,,72,59,131,80,0.436113,0.110051,91,101,192,7,0.302727,0.399275,35.517691,0,0.001334
n285,lib/Type/X/IO/Rename.pod,,73,58,131,80,0.436113,0.110051,93,99,192,7,0.302727,0.399275,35.517691,0,0.001334
n286,lib/Type/X/IO/Rmdir.pod,,74,57,131,80,0.436113,0.110051,95,97,192,7,0.302727,0.399275,35.517691,0,0.001334
n287,lib/Type/X/IO/Unlink.pod,,76,56,132,80,0.429505,0.110116,98,95,193,7,0.302831,0.399845,482.687272,0,0.001379
n288,lib/Type/X/Inheritance/Unsupported.pod,,76,55,131,80,0.436113,0.110051,99,93,192,7,0.302727,0.399275,35.517691,0,0.001334
n289,lib/Type/X/Method/InvalidQualifier.pod,,77,54,131,80,0.436113,0.110051,101,91,192,7,0.302727,0.399275,35.517691,0,0.001334
n290,lib/Type/X/Method/NotFound.pod,,78,53,131,80,0.436113,0.110051,103,89,192,7,0.302727,0.399275,35.517691,0,0.001334
n291,lib/Type/X/Method/Private/Permission.pod,,79,52,131,80,0.436113,0.110051,105,87,192,7,0.302727,0.399275,35.517691,0,0.001334
n292,lib/Type/X/Method/Private/Unqualified.pod,,80,51,131,80,0.436113,0.110051,107,85,192,7,0.302727,0.399275,35.517691,0,0.001334
n293,lib/Type/X/Mixin/NotComposable.pod,,83,51,134,80,0.42195,0.111487,120,87,207,7,0.303041,0.400986,62.371093,0,0.001365
n294,lib/Type/X/NYI.pod,,82,49,131,80,0.436113,0.110051,113,84,197,7,0.302727,0.399275,35.517691,0,0.001334
n295,lib/Type/X/NoDispatcher.pod,,83,48,131,80,0.436113,0.110051,113,79,192,7,0.302727,0.399275,35.517691,0,0.001334
n296,lib/Type/X/Numeric/Real.pod,,84,47,131,80,0.436113,0.110051,115,77,192,7,0.302727,0.399275,35.517691,0,0.001334
n297,lib/Type/X/OS.pod,,129,58,187,80,0.289863,0.133376,192,90,282,7,0.308912,0.431582,1520.69721,0,0.001928
n298,lib/Type/X/OutOfRange.pod,,87,44,131,80,0.436113,0.110051,123,74,197,7,0.302727,0.399275,35.517691,0,0.001334
n299,lib/Type/X/Package/Stubbed.pod,,88,43,131,80,0.436113,0.110051,122,70,192,7,0.302727,0.399275,35.517691,0,0.001334
n300,lib/Type/X/Parameter/Default.pod,,89,42,131,80,0.436113,0.110051,124,68,192,7,0.302727,0.399275,35.517691,0,0.001334
n301,lib/Type/X/Parameter/MultipleTypeConstraints.pod,,92,42,134,80,0.42195,0.111487,138,69,207,7,0.303041,0.400986,62.371093,0,0.001365
n302,lib/Type/X/Parameter/Placeholder.pod,,91,40,131,80,0.436113,0.110051,128,64,192,7,0.302727,0.399275,35.517691,0,0.001334
n303,lib/Type/X/Parameter/Twigil.pod,,92,39,131,80,0.436113,0.110051,130,62,192,7,0.302727,0.399275,35.517691,0,0.001334
n304,lib/Type/X/Parameter/WrongOrder.pod,,93,38,131,80,0.436113,0.110051,132,60,192,7,0.302727,0.399275,35.517691,0,0.001334
n305,lib/Type/X/Phaser/Multiple.pod,,96,37,133,80,0.424129,0.110326,140,59,199,7,0.302936,0.400415,73.606007,0,0.001388
n306,lib/Type/X/Phaser/PrePost.pod,,97,37,134,80,0.42195,0.111487,149,58,207,7,0.303041,0.400986,62.371093,0,0.001365
n307,lib/Type/X/Placeholder/Block.pod,,96,35,131,80,0.436113,0.110051,138,54,192,7,0.302727,0.399275,35.517691,0,0.001334
n308,lib/Type/X/Redeclaration.pod,,98,33,131,80,0.436113,0.110051,145,52,197,7,0.302727,0.399275,35.517691,0,0.001334
n309,lib/Type/X/Role/Initialization.pod,,99,32,131,80,0.436113,0.110051,143,49,192,7,0.302727,0.399275,35.517691,0,0.001334
n310,lib/Type/X/Signature/NameClash.pod,,101,30,131,80,0.436113,0.110051,146,46,192,7,0.302727,0.399275,35.517691,0,0.001334
n311,lib/Type/X/Signature/Placeholder.pod,,102,29,131,80,0.436113,0.110051,148,44,192,7,0.302727,0.399275,35.517691,0,0.001334
n312,lib/Type/X/Str/Numeric.pod,,103,28,131,80,0.436113,0.110051,155,42,197,7,0.302727,0.399275,35.517691,0,0.001334
n313,lib/Type/X/Syntax/Augment/Role.pod,,106,27,133,80,0.424129,0.110326,161,41,202,7,0.302936,0.400415,73.606007,0,0.001388
n314,lib/Type/X/Syntax/InfixInTermPosition.pod,,108,23,131,80,0.436113,0.110051,157,35,192,7,0.302727,0.399275,35.517691,0,0.001334
n315,lib/Type/X/Syntax/Missing.pod,,109,22,131,80,0.436113,0.110051,159,33,192,7,0.302727,0.399275,35.517691,0,0.001334
n316,lib/Type/X/Syntax/NegatedPair.pod,,110,21,131,80,0.436113,0.110051,161,31,192,7,0.302727,0.399275,35.517691,0,0.001334
n317,lib/Type/X/Syntax/NoSelf.pod,,111,20,131,80,0.436113,0.110051,163,29,192,7,0.302727,0.399275,35.517691,0,0.001334
n318,lib/Type/X/Syntax/Number/RadixOutOfRange.pod,,112,19,131,80,0.436113,0.110051,165,27,192,7,0.302727,0.399275,35.517691,0,0.001334
n319,lib/Type/X/Syntax/Obsolete.pod,,99,8,107,80,0.5,0.096231,99,8,107,7,0.297389,0.382152,0,0,0.001102
n320,lib/Type/X/Syntax/Regex/Adverb.pod,,115,16,131,80,0.436113,0.110051,169,23,192,7,0.302727,0.399275,35.517691,0,0.001334
n321,lib/Type/X/Syntax/Reserved.pod,,120,14,134,80,0.421333,0.111299,177,20,197,7,0.303146,0.401176,66.60838,0,0.001369
n322,lib/Type/X/Syntax/Variable/Numeric.pod,,123,8,131,80,0.436113,0.110051,179,13,192,7,0.302727,0.399275,35.517691,0,0.001334
n323,lib/Type/X/Syntax/Variable/Twigil.pod,,124,7,131,80,0.436113,0.110051,181,11,192,7,0.302727,0.399275,35.517691,0,0.001334
n324,lib/Type/X/Temporal/Truncation.pod,,125,6,131,80,0.436113,0.110051,183,9,192,7,0.302727,0.399275,35.517691,0,0.001334
n325,lib/Type/X/TypeCheck.pod,,126,5,131,80,0.436113,0.110051,185,7,192,7,0.302727,0.399275,35.517691,0,0.001334
n326,lib/Type/X/TypeCheck/Splice.pod,,130,1,131,80,0.436113,0.110051,190,2,192,7,0.302727,0.399275,35.517691,0,0.001334
n327,lib/Type/X/Undeclared.pod,,131,0,131,80,0.436113,0.110051,192,0,192,7,0.302727,0.399275,35.517691,0,0.001334
n328,lib/HomePage.pod,,3,1,4,95,0.333333,0.000615,5,1,6,6,0.324815,0.343139,6.563743,0,0.000393
n329,lib/Language/terms.pod,,16,11,27,80,0.260684,0.011455,28,13,41,6,0.356504,0.397662,1268.117626,0,0.000826
n330,lib/Pod/Convenience.pm6,,12,2,14,95,0.208791,0.001699,19,2,21,5,0.342846,0.368187,5060.573007,0,0.001262
n331,lib/Language/Sets_Bags_and_Mixes.pod,,2,95,97,80,0.392612,0.070056,3,97,100,6,0.366332,0.436621,8861.758999,0,0.001379
n332,lib/Language/classtut.pod,,4,13,17,80,0.334559,0.006023,4,24,28,6,0.353629,0.390061,418.054889,0,0.00064
n333,lib/Language/containers.pod,,6,15,21,80,0.32381,0.006185,8,27,35,6,0.355348,0.393862,746.369679,0,0.000766
n334,lib/Language/glossary.pod,,6,8,14,80,0.478022,0.003318,8,14,22,6,0.339134,0.368871,2.64572,0,0.000607
n335,lib/Language/modules.pod,,8,6,14,80,0.478022,0.003318,11,11,22,6,0.339134,0.368871,2.64572,0,0.000607
n336,lib/Language/objects.pod,,11,101,112,80,0.31258,0.075697,25,114,139,6,0.382802,0.456024,15262.620217,0,0.001677
n337,lib/Language/operators.pod,,14,14,28,80,0.202381,0.008244,24,21,45,6,0.356649,0.398233,3593.869786,0,0.001094
n338,lib/Language/regexes.pod,,12,8,20,80,0.318421,0.008589,24,11,35,6,0.3542,0.391961,505.926649,0,0.000671
n339,lib/Language/variables.pod,,25,5,30,80,0.183908,0.007745,41,5,46,5,0.365264,0.404295,6622.861717,0,0.001283
n340,lib/Language/quoting.pod,,10,3,13,80,0.5,0.003229,13,5,18,6,0.33861,0.367731,0,0,0.000547
n341,lib/Type/X/Obsolete.pod,,41,45,86,80,0.488782,0.068754,42,45,87,6,0.353629,0.415222,4383.443215,0,0.000964
n342,lib/Language/grammars.pod,,8,95,103,80,0.367219,0.072952,11,103,114,6,0.36618,0.438902,8286.899271,0,0.001553
n343,index.p6,,1,0,1,95,0,0.000076,1,0,1,5,0.256358,0.265203,0,0,0.000224
n344,lib/Language/traps.pod,,1,1,2,80,0.5,0.001155,1,1,2,7,0.239945,0.2801,0,0,0.000212
n345,bin/p6doc-index,,4,7,11,95,0.290909,0.005572,8,10,18,5,0.381636,0.405625,2319.636071,0,0.000665
n346,lib/Type/IO/Path.pod,,26,32,58,80,0.456443,0.040803,35,32,67,6,0.347189,0.397339,4259.144552,0,0.000787
n347,lib/Language/functions.pod,,1,11,12,80,0.159091,0.004838,1,12,13,6,0.286789,0.326986,320.475167,0,0.000622
n348,lib/Type/X/Syntax/Term/MissingInitializer.pod,,86,12,98,80,0.443089,0.078109,89,12,101,6,0.35607,0.423014,5040.167133,0,0.001077
n349,lib/Type/X/Syntax/Regex/SolitaryQuantifier.pod,,70,16,86,80,0.488782,0.068754,70,16,86,6,0.353629,0.415222,4383.443215,0,0.000964
n350,lib/Language/mop.pod,,3,2,5,80,0.4,0.001817,3,2,5,6,0.336273,0.361365,118.810551,0,0.000304
n351,lib/Type/Metamodel/Naming.pod,,24,50,74,80,0.5,0.042518,28,62,90,7,0.294197,0.363528,0,0,0.000913
n352,lib/Type/Metamodel/C3MRO.pod,,18,56,74,80,0.5,0.042518,21,69,90,7,0.294197,0.363528,0,0,0.000913
n353,lib/Type/AST.pod,,0,54,54,80,0.5,0.038644,0,54,54,7,0.291847,0.351366,0,0,0.00068
n354,lib/Type/Array.pod,,2,52,54,80,0.5,0.038644,2,53,55,7,0.291847,0.351366,0,0,0.00068
n355,lib/Type/Block.pod,,6,48,54,80,0.5,0.038644,6,48,54,7,0.291847,0.351366,0,0,0.00068
n356,lib/Type/Bool.pod,,7,47,54,80,0.5,0.038644,7,47,54,7,0.291847,0.351366,0,0,0.00068
n357,lib/Type/Cool.pod,,22,49,71,80,0.320322,0.04361,23,51,74,6,0.354773,0.410148,5979.278442,0,0.001167
n358,lib/Type/Cursor.pod,,13,41,54,80,0.5,0.038644,13,41,54,7,0.291847,0.351366,0,0,0.00068
n359,lib/Type/Duration.pod,,15,39,54,80,0.5,0.038644,15,39,54,7,0.291847,0.351366,0,0,0.00068
n360,lib/Type/FatRat.pod,,20,34,54,80,0.5,0.038644,20,34,54,7,0.291847,0.351366,0,0,0.00068
n361,lib/Type/Instant.pod,,24,30,54,80,0.5,0.038644,24,30,54,7,0.291847,0.351366,0,0,0.00068
n362,lib/Type/Junction.pod,,27,27,54,80,0.5,0.038644,27,27,54,7,0.291847,0.351366,0,0,0.00068
n363,lib/Type/Macro.pod,,29,25,54,80,0.5,0.038644,29,25,54,7,0.291847,0.351366,0,0,0.00068
n364,lib/Type/Method.pod,,31,23,54,80,0.5,0.038644,31,23,54,7,0.291847,0.351366,0,0,0.00068
n365,lib/Type/Num.pod,,34,20,54,80,0.5,0.038644,34,20,54,7,0.291847,0.351366,0,0,0.00068
n366,lib/Type/ObjAt.pod,,35,19,54,80,0.5,0.038644,35,19,54,7,0.291847,0.351366,0,0,0.00068
n367,lib/Type/Parcel.pod,,38,16,54,80,0.5,0.038644,38,16,54,7,0.291847,0.351366,0,0,0.00068
n368,lib/Type/Pod/Block/Para.pod,,71,47,118,80,0.316891,0.070628,78,50,128,7,0.298807,0.388994,160.039801,0,0.001347
n369,lib/Type/QuantHash.pod,,79,39,118,80,0.316891,0.070628,95,49,144,7,0.298807,0.388994,160.039801,0,0.001347
n370,lib/Type/Rat.pod,,46,8,54,80,0.5,0.038644,46,8,54,7,0.291847,0.351366,0,0,0.00068
n371,lib/Type/Sub.pod,,51,3,54,80,0.5,0.038644,51,3,54,7,0.291847,0.351366,0,0,0.00068
n372,lib/Type/WhateverCode.pod,,54,0,54,80,0.5,0.038644,54,0,54,7,0.291847,0.351366,0,0,0.00068
n373,lib/Type/Callable.pod,,4,71,75,80,0.49009,0.043288,4,73,77,7,0.294295,0.364098,2.70342,0,0.000921
n374,lib/Type/Associative.pod,,0,86,86,80,0.413133,0.052691,0,105,105,7,0.295485,0.37056,36.267123,0,0.001021
n375,lib/Type/Iterable.pod,,15,62,77,80,0.469925,0.044303,17,77,94,7,0.294493,0.365239,154.368505,0,0.000974
n376,lib/Type/Stringy.pod,,50,24,74,80,0.5,0.042518,61,29,90,7,0.294197,0.363528,0,0,0.000913
n377,lib/Type/X/IO.pod,,60,14,74,80,0.5,0.042518,72,18,90,7,0.294197,0.363528,0,0,0.000913
n378,lib/Type/X/Pod.pod,,63,11,74,80,0.5,0.042518,77,13,90,7,0.294197,0.363528,0,0,0.000913
n379,lib/Type/X/Syntax.pod,,70,4,74,80,0.5,0.042518,85,5,90,7,0.294197,0.363528,0,0,0.000913
n380,lib/Type/X/Temporal.pod,,73,1,74,80,0.5,0.042518,89,1,90,7,0.294197,0.363528,0,0,0.000913
n381,lib/Type/X/Constructor/Positional.pod,,15,70,85,80,0.5,0.068539,15,70,85,7,0.296986,0.371149,0,0,0.000917
n382,lib/Type/X/ControlFlow/Return.pod,,17,68,85,80,0.5,0.068539,17,68,85,7,0.296986,0.371149,0,0,0.000917
n383,lib/Type/X/Declaration/Scope/Multi.pod,,19,66,85,80,0.5,0.068539,19,66,85,7,0.296986,0.371149,0,0,0.000917
n384,lib/Type/X/IO/Chmod.pod,,23,62,85,80,0.5,0.068539,23,62,85,7,0.296986,0.371149,0,0,0.000917
n385,lib/Type/X/IO/Cwd.pod,,29,60,89,80,0.474081,0.070859,30,62,92,7,0.297692,0.374,19.659842,0,0.000991
n386,lib/Type/X/Placeholder/Mainline.pod,,52,33,85,80,0.5,0.068539,52,33,85,7,0.296986,0.371149,0,0,0.000917
n387,lib/Type/X/Sequence/Deduction.pod,,55,30,85,80,0.5,0.068539,55,30,85,7,0.296986,0.371149,0,0,0.000917
n388,lib/Type/X/Syntax/Augment/WithoutMonkeyTyping.pod,,63,25,88,80,0.467999,0.069787,67,26,93,7,0.29749,0.373239,28.087686,0,0.000952
n389,lib/Type/X/Syntax/Comment/Embedded.pod,,61,24,85,80,0.5,0.068539,61,24,85,7,0.296986,0.371149,0,0,0.000917
n390,lib/Type/X/Syntax/Confused.pod,,62,23,85,80,0.5,0.068539,62,23,85,7,0.296986,0.371149,0,0,0.000917
n391,lib/Type/X/Syntax/P5.pod,,68,17,85,80,0.5,0.068539,68,17,85,7,0.296986,0.371149,0,0,0.000917
n392,lib/Type/X/Syntax/Self/WithoutObject.pod,,72,13,85,80,0.5,0.068539,72,13,85,7,0.296986,0.371149,0,0,0.000917
n393,lib/Type/X/Syntax/Signature/InvocantMarker.pod,,73,12,85,80,0.5,0.068539,73,12,85,7,0.296986,0.371149,0,0,0.000917
n394,lib/Type/X/Syntax/UnlessElse.pod,,75,10,85,80,0.5,0.068539,75,10,85,7,0.296986,0.371149,0,0,0.000917
n395,lib/Type/X/Syntax/Variable/Match.pod,,76,9,85,80,0.5,0.068539,76,9,85,7,0.296986,0.371149,0,0,0.000917
n396,lib/Type/X/TypeCheck/Assignment.pod,,81,4,85,80,0.5,0.068539,81,4,85,7,0.296986,0.371149,0,0,0.000917
n397,lib/Type/X/TypeCheck/Binding.pod,,82,3,85,80,0.5,0.068539,82,3,85,7,0.296986,0.371149,0,0,0.000917
n398,lib/Type/X/TypeCheck/Return.pod,,83,2,85,80,0.5,0.068539,83,2,85,7,0.296986,0.371149,0,0,0.000917
n399,lib/Type/Stash.pod,,49,25,74,80,0.5,0.042518,49,25,74,7,0.294197,0.363528,0,0,0.000913
n400,lib/Language/setbagmix.pod,,4,17,21,80,0.252381,0.009585,4,17,21,5,0.305575,0.347301,4045.987434,0,0.000624
n401,lib/Type/BagHash.pod,,2,7,9,80,0.5,0.005625,2,7,9,6,0.245178,0.285291,0,0,0.000294
n402,lib/Type/MixHash.pod,,5,4,9,80,0.5,0.005625,5,4,9,6,0.245178,0.285291,0,0,0.000294
n403,lib/Type/SetHash.pod,,8,1,9,80,0.5,0.005625,8,1,9,6,0.245178,0.285291,0,0,0.000294
n404,util/new-type.p6,,17,1,18,95,0.212418,0.006598,19,1,20,5,0.387026,0.414937,3053.385477,0,0.000914
n405,lib/Type/Promise.pod,,47,40,87,80,0.403903,0.052756,50,41,91,7,0.295585,0.37113,252.735503,0,0.001074
n406,lib/Type/Channel.pod,,1,2,3,80,0.5,0.00195,1,3,4,8,0.235753,0.276981,0,0,0.000189
n407,lib/Type/Lock.pod,,4,0,4,80,0.5,0.002575,4,0,4,7,0.240868,0.281658,0,0,0.000199
n408,lib/Type/Supply.pod,,63,22,85,80,0.396359,0.046107,66,23,89,6,0.304831,0.377803,1052.429871,0,0.001192
n409,lib/Type/Tap.pod,,53,21,74,80,0.5,0.042518,54,21,75,7,0.294197,0.363528,0,0,0.000913
n410,lib/Type/Blob.pod,,4,72,76,80,0.480175,0.043757,4,72,76,7,0.294493,0.364859,8.129016,0,0.000936
n411,lib/Type/X/Syntax/Malformed.pod,,72,2,74,80,0.5,0.042518,72,2,74,7,0.294197,0.363528,0,0,0.000913
n412,lib/Type/Metamodel/Trusting.pod,,28,46,74,80,0.5,0.042518,28,46,74,7,0.294197,0.363528,0,0,0.000913
n413,lib/Type/X/Syntax/AddCategorial/MissingSeparator.pod,,82,5,87,80,0.404571,0.052905,85,5,90,6,0.352067,0.415013,4321.084929,0,0.001067
n414,lib/Type/Metamodel/Finalization.pod,,20,54,74,80,0.5,0.042518,20,54,74,7,0.294197,0.363528,0,0,0.000913
n415,lib/Type/Metamodel/RoleContainer.pod,,27,47,74,80,0.5,0.042518,27,47,74,7,0.294197,0.363528,0,0,0.000913
n416,lib/Type/Metamodel/Primitives.pod,,26,49,75,80,0.487207,0.042648,27,49,76,7,0.296184,0.366664,82.368327,0,0.000946
n417,lib/Type/Metamodel/ClassHOW.pod,,20,55,75,80,0.487928,0.043156,21,57,78,7,0.295884,0.366189,34.053296,0,0.000925
n418,lib/Type/Metamodel/AttributeContainer.pod,,18,57,75,80,0.487928,0.043156,18,60,78,7,0.295884,0.366189,34.053296,0,0.000925
n419,lib/Type/Metamodel/MethodContainer.pod,,24,52,76,80,0.475789,0.043286,26,54,80,7,0.296384,0.367424,116.421624,0,0.000959
n420,lib/Type/Metamodel/MultipleInheritance.pod,,24,52,76,80,0.476316,0.04337,27,53,80,6,0.351926,0.410072,3738.143126,0,0.000972
n421,lib/Type/Label.pod,,17,63,80,80,0.439715,0.045295,18,63,81,7,0.29479,0.366949,334.250667,0,0.001098
n422,lib/Type/Metamodel/PrivateMethodContainer.pod,,26,48,74,80,0.5,0.042518,26,48,74,7,0.294197,0.363528,0,0,0.000913
n423,lib/Type/Submethod.pod,,51,23,74,80,0.5,0.042518,51,23,74,7,0.294197,0.363528,0,0,0.000913
n424,lib/Type/Variable.pod,,4,0,4,80,0.25,0.001697,4,0,4,6,0.34582,0.374857,840.156015,0,0.000275
n425,lib/Type/Metamodel/MROBasedMethodDispatch.pod,,21,53,74,80,0.5,0.042518,21,53,74,7,0.294197,0.363528,0,0,0.000913
n426,lib/Type/Proc/Status.pod,,41,33,74,80,0.5,0.042518,42,33,75,7,0.294197,0.363528,0,0,0.000913
n427,lib/Type/X/Assignment/RO.pod,,0,0,0,81,0,0,0,0,0,0,0,0,0,0,0
n428,README.md,,2,22,24,95,0.20471,0.007716,3,27,30,5,0.390994,0.420924,4478.427682,0,0.00111
n429,lib/Type/Proc/Async.pod,,40,34,74,80,0.5,0.042518,41,39,80,7,0.294197,0.363528,0,0,0.000913
n430,lib/Type/X/Proc/Async/TapBeforeSpawn.pod,,69,5,74,80,0.5,0.042518,70,5,75,7,0.294197,0.363528,0,0,0.000913
n431,lib/Type/X/Proc/Async/AlreadyStarted.pod,,65,9,74,80,0.5,0.042518,66,9,75,7,0.294197,0.363528,0,0,0.000913
n432,lib/Type/X/Proc/Async/MustBeStarted.pod,,69,9,78,80,0.457875,0.045018,71,10,81,7,0.296284,0.368089,59.595447,0,0.000957
n433,lib/Type/X/Proc/Async/OpenForWriting.pod,,68,6,74,80,0.5,0.042518,70,6,76,7,0.294197,0.363528,0,0,0.000913
n434,lib/Type/X/Proc/Async/CharsOrBytes.pod,,66,8,74,80,0.5,0.042518,67,8,75,7,0.294197,0.363528,0,0,0.000913
n435,html/css/pygments.css,,5,3,8,95,0.303571,0.000811,5,3,8,6,0.324815,0.344565,430.161282,0,0.000839
n436,lib/Type/X/Bind.pod,,55,19,74,80,0.5,0.042518,55,19,74,7,0.294197,0.363528,0,0,0.000913
n437,lib/Type/X/Bind/Slice.pod,,56,18,74,80,0.5,0.042518,56,18,74,7,0.294197,0.363528,0,0,0.000913
n438,util/missing-methods.p6,,0,0,0,82,0,0,0,0,0,0,0,0,0,0,0
n439,util/update-and-sync,,26,0,26,95,0.298462,0.004627,27,0,27,6,0.332197,0.36393,306.546186,0,0.00102
n440,util/sync-build-log,,1,1,2,95,0.5,0.000445,1,1,2,6,0.321835,0.33894,0,0,0.000231
n441,lib/Type/X/Does/TypeObject.pod,,59,15,74,80,0.5,0.042518,59,15,74,7,0.294197,0.363528,0,0,0.000913
n442,lib/Type/X/Inheritance/NotComposed.pod,,61,14,75,80,0.487748,0.042732,62,14,76,6,0.35024,0.407982,3704.089829,0,0.000959
n443,lib/Language/5to6.pod,,0,0,0,83,0,0,0,0,0,0,0,0,0,0,0
n444,lib/Type/Dateish.pod,,12,68,80,80,0.44019,0.045981,12,69,81,7,0.296484,0.36923,138.464204,0,0.000994
n445,lib/Language/unicode_entry.pod,,7,1,8,80,0.285714,0.001217,7,1,8,6,0.276656,0.304371,32.204638,0,0.000588
n446,lib/Language/io.pod,,0,5,5,80,0.45,0.002841,0,6,6,6,0.33666,0.362182,0.021739,0,0.000249
n447,lib/Type/DateTime.pod,,8,67,75,80,0.487568,0.04262,8,67,75,7,0.294295,0.364098,53.079716,0,0.00094
n448,lib/Type/X/Proc/Async.pod,,64,11,75,80,0.487748,0.042732,64,11,75,6,0.35024,0.407982,3704.089829,0,0.000959
n449,lib/Language/about.pod,,0,4,4,80,0.5,0.000908,0,4,4,7,0.271097,0.298306,0,0,0.000311
n450,lib/Type/nativeInt.pod,,75,1,76,80,0.475088,0.043062,75,1,76,6,0.374466,0.432744,14997.964966,0,0.000998
n451,lib/Language/testing.pod,,0,0,0,84,0,0,0,0,0,0,0,0,0,0,0
n452,t/pod-convenience.t,,2,14,16,144,0.5,0.002611,2,16,18,6,0.299011,0.323147,0,0,0.000774
n453,lib/Type/Thread.pod,,3,1,4,80,0.333333,0.001469,3,1,4,7,0.27544,0.309651,10.092243,0,0.000265
n454,lib/Pod/Htmlify.pm6,,4,4,8,95,0.25,0.000889,18,13,31,6,0.329328,0.350456,100.076703,0,0.000681
n455,t/pod-htmlify.t,,5,13,18,144,0.398693,0.003005,7,13,20,6,0.347602,0.372862,1094.088499,0,0.000886
n456,Makefile,,3,13,16,95,0.15,0.006407,4,18,22,6,0.372874,0.402338,2373.942085,0,0.001229
n457,CONTRIBUTING.md,,3,59,62,144,0.130354,0.11285,3,92,95,6,0.411544,0.461631,23510.080036,0,0.002089
n458,lib/Type/CurrentThreadScheduler.pod,,7,69,76,80,0.475088,0.042679,7,70,77,7,0.294394,0.364669,471.217246,0,0.000999
n459,lib/Type/Scheduler.pod,,48,28,76,80,0.475088,0.042679,49,28,77,7,0.294394,0.364669,471.217246,0,0.000999
n460,lib/Type/ThreadPoolScheduler.pod,,3,0,3,80,0.5,0.000919,3,0,3,8,0.22797,0.255126,0,0,0.000208
n461,lib/Type/IO/Socket.pod,,14,62,76,80,0.475088,0.042685,14,64,78,7,0.294394,0.364669,260.428568,0,0.000986
n462,lib/Type/IO/Socket/INET.pod,,3,1,4,80,0.166667,0.001802,4,1,5,8,0.236516,0.278406,0.466113,0,0.000216
n463,lib/Language/nativecall.pod,,1,4,5,80,0.3,0.000728,1,4,5,6,0.274835,0.29905,35.88401,0,0.000432
n464,bin/p6doc.bat,,0,0,0,85,0,0,0,0,0,0,0,0,0,0,0
n465,lib/Type/PairMap.pod,,0,0,0,86,0,0,0,0,0,0,0,0,0,0,0
n466,lib/Language/syntax.pod,,4,3,7,80,0.238095,0.001331,5,3,8,6,0.279923,0.310927,100.102561,0,0.000602
n467,lib/Language/exceptions.pod,,1,0,1,80,0,0.000057,1,0,1,8,0.20866,0.21712,0,0,0.000285
n468,lib/Language/control.pod,,1,4,5,80,0.35,0.00038,1,5,6,6,0.268442,0.284987,18.590964,0,0.000531
n469,lib/Language/concurrency.pod,,0,4,4,80,0.083333,0.000308,0,4,4,7,0.263601,0.281012,877.065521,0,0.000598
n470,lib/Type/Proxy.pod,,45,31,76,80,0.474737,0.042679,45,31,76,7,0.294691,0.365239,259.733644,0,0.001013
n471,lib/Type/X/Promise/CauseOnlyValidOnBroken.pod,,0,0,0,87,0,0,0,0,0,0,0,0,0,0,0
n472,lib/Type/X/StubCode.pod,,0,0,0,88,0,0,0,0,0,0,0,0,0,0,0
n473,lib/Type/IO/Spec.pod,,0,4,4,92,0.5,0.000224,0,4,4,1,1,1,0,17,0.001053
n474,lib/Type/Proc.pod,,39,35,74,80,0.5,0.042518,39,36,75,7,0.294197,0.363528,0,0,0.000913
n475,lib/Type/IO/Socket/Async.pod,,14,61,75,80,0.486847,0.042583,15,61,76,7,0.294295,0.364098,207.348852,0,0.000958
n476,lib/Type/IO/Pipe.pod,,12,62,74,80,0.5,0.042518,12,62,74,7,0.294197,0.363528,0,0,0.000913
n477,lib/Type/IO/Notification.pod,,11,63,74,80,0.5,0.042518,11,63,74,7,0.294197,0.363528,0,0,0.000913
n478,lib/Type/IO/ArgFiles.pm,,0,0,0,89,0,0,0,0,0,0,0,0,0,0,0
n479,lib/Language/subscripting.pod,,0,0,0,90,0,0,0,0,0,0,0,0,0,0,0
n480,lib/Type/X/Channel/SendOnClosed.pod,,58,17,75,80,0.487748,0.042732,58,17,75,6,0.35024,0.407982,3704.089829,0,0.000959
n481,lib/Type/X/Channel/ReceiveOnClosed.pod,,58,17,75,80,0.487027,0.042583,58,17,75,7,0.294295,0.364098,162.675617,0,0.000966
n482,lib/Language/subscripts.pod,,5,6,11,80,0.5,0.003974,6,7,13,6,0.296584,0.334474,0,0,0.000418
n483,lib/Language/5to6-perlfunc.pod,,0,3,3,80,0.5,0.000201,0,4,4,7,0.229101,0.24631,0,0,0.00048
n484,lib/Language/5to6-perlop.pod,,1,13,14,80,0.318681,0.004135,2,13,15,6,0.296886,0.336184,2622,0,0.00081
n485,lib/Language/5to6-perlsyn.pod,,2,1,3,80,0.5,0.000201,2,1,3,7,0.229101,0.24631,0,0,0.00048
n486,lib/Language/5to6-perlvar.pod,,3,0,3,80,0.5,0.000201,3,0,3,7,0.229101,0.24631,0,0,0.00048
n487,html/css/custom-theme/jquery-ui.css,,1,5,6,95,0.433333,0.00047,1,6,7,6,0.276047,0.290023,34.097185,0,0.000652
n488,html/js/jquery-1.11.3.min.js,,1,3,4,95,0.5,0.00028,1,4,5,6,0.253322,0.264709,0,0,0.00051
n489,html/js/jquery-ui.min.js,,4,2,6,95,0.433333,0.00047,5,2,7,6,0.276047,0.290023,34.097185,0,0.000652
n490,lib/Type/Temporal.pod,,0,0,0,91,0,0,0,0,0,0,0,0,0,0,0
n491,lib/Type/IO/Spec/Cygwin.pod,,1,3,4,92,0.5,0.000224,1,6,7,1,1,1,0,17,0.001053
n492,lib/Type/IO/Spec/QNX.pod,,2,2,4,92,0.5,0.000224,3,4,7,1,1,1,0,17,0.001053
n493,lib/Type/IO/Spec/Unix.pod,,3,1,4,92,0.5,0.000224,5,2,7,1,1,1,0,17,0.001053
n494,lib/Type/IO/Spec/Win32.pod,,4,0,4,92,0.5,0.000224,7,0,7,1,1,1,0,17,0.001053
n495,lib/Type/Seq.pod,,0,0,0,93,0,0,0,0,0,0,0,0,0,0,0
n496,lib/Type/PositionalBindFailover.pod,,1,1,2,95,0.5,0.000618,1,1,2,6,0.321363,0.337666,0,0,0.000218
n497,lib/Type/Slip.pod,,0,1,1,95,0,0.000217,0,1,1,6,0.311656,0.322976,0,0,0.000204
n498,doc/Type/Mu.pod,,48,20,68,95,0.332748,0.013079,70,27,97,6,0.342044,0.393025,618.514552,0,0.001962
n499,doc/Type/Nil.pod,,33,10,43,95,0.39258,0.008313,43,11,54,7,0.28474,0.327667,14.802437,0,0.001205
n500,doc/Type/Numeric.pod,,2,0,2,95,0.5,0.000319,2,0,2,7,0.270512,0.287207,0,0,0.000211
n501,doc/Type/Proc/Async.pod,,0,1,1,94,0,0.000052,0,1,1,1,1,1,0,18,0.001053
n502,doc/Type/Proc/Status.pod,,1,0,1,94,0,0.000052,1,0,1,1,1,1,0,18,0.001053
n503,doc/Type/Int.pod,,42,22,64,95,0.3812,0.012878,53,25,78,6,0.340715,0.389605,753.985864,0,0.001775
n504,html/js/main.js,,5,3,8,95,0.339286,0.001248,11,6,17,6,0.31984,0.338331,104.195521,0,0.000671
n505,doc/Type/List.pod,,55,42,97,95,0.236899,0.018381,96,55,151,6,0.374947,0.43569,4956.854218,0,0.002587
n506,doc/Language/modules.pod,,19,89,108,95,0.192714,0.018177,39,139,178,6,0.375107,0.440251,8539.577711,0,0.003223
n507,doc/Type/IO/Handle.pod,,35,34,69,95,0.332907,0.014854,46,40,86,6,0.370042,0.419156,1402.939803,0,0.001877
n508,doc/Type/IO/Path.pod,,33,32,65,95,0.384615,0.013159,47,42,89,6,0.34098,0.390365,245.434791,0,0.001735
n509,doc/Type/IO/Socket/Async.pod,,38,33,71,95,0.34829,0.013956,56,44,100,6,0.342177,0.394356,399.15024,0,0.001908
n510,doc/Type/IO/Spec.pod,,15,12,27,95,0.485755,0.005504,16,18,34,7,0.282721,0.317405,0.447658,0,0.000806
n511,doc/Type/IO/Spec/Cygwin.pod,,16,11,27,95,0.485755,0.005504,19,15,34,7,0.282721,0.317405,0.447658,0,0.000806
n512,doc/Type/IO/Spec/QNX.pod,,17,10,27,95,0.485755,0.005504,22,12,34,7,0.282721,0.317405,0.447658,0,0.000806
n513,doc/Language/traps.pod,,22,65,87,95,0.274258,0.015742,42,87,129,6,0.344192,0.403288,1039.455203,0,0.002319
n514,.travis.yml,,1,9,10,136,0.266667,0.021789,1,9,10,6,0.326508,0.361574,490.48663,0,0.000429
n515,doc/Language/regexes.pod,,19,40,59,95,0.408533,0.012179,23,44,67,6,0.340715,0.387704,62.733974,0,0.001642
n516,doc/Type/Code.pod,,0,1,1,107,0,0.000052,0,1,1,1,1,1,0,19,0.001053
n517,doc/Type/Array.pod,,22,46,68,95,0.316725,0.01429,28,51,79,6,0.369886,0.418586,6493.229481,0,0.002102
n518,doc/Type/Routine.pod,,7,0,7,95,0.357143,0.001234,9,0,9,7,0.264955,0.288006,9.710084,0,0.000433
n519,Build.pm,,0,8,8,95,0.339286,0.005277,0,9,9,5,0.37688,0.399829,1329.092836,0,0.000538
n520,doc/Type/Str.pod,,65,23,88,95,0.262017,0.01573,91,25,116,6,0.344868,0.404618,1118.807108,0,0.002402
n521,doc/Language/5to6-perlvar.pod,,4,36,40,95,0.35641,0.00764,13,42,55,6,0.33435,0.372577,234.940576,0,0.001215
n522,doc/Language/5to6-perlfunc.pod,,1,60,61,95,0.271858,0.010136,3,94,97,7,0.286414,0.33793,128.505979,0,0.001723
n523,doc/Type/Supply.pod,,51,23,74,95,0.315624,0.013983,77,23,100,6,0.342578,0.396066,825.090152,0,0.002009
n524,doc/Language/operators.pod,,17,71,88,95,0.255878,0.015687,28,102,130,6,0.356794,0.414975,3300.222439,0,0.002494
n525,doc/Type/Associative.pod,,2,5,7,95,0.5,0.001324,2,5,7,6,0.329823,0.35076,0,0,0.000402
n526,doc/Type/Cool.pod,,24,34,58,95,0.394737,0.011841,27,38,65,6,0.352067,0.397301,1673.716457,0,0.001774
n527,doc/Type/Hash.pod,,32,39,71,95,0.313682,0.015046,51,48,99,6,0.374626,0.425333,2638.182115,0,0.002013
n528,doc/Type/Map.pod,,5,2,7,95,0.5,0.001324,5,2,7,6,0.329823,0.35076,0,0,0.000402
n529,doc/Type/Pod/Block.pod,,6,1,7,95,0.5,0.001324,6,1,7,6,0.329823,0.35076,0,0,0.000402
n530,doc/Language/objects.pod,,16,64,80,95,0.273418,0.016012,25,85,110,6,0.371768,0.425428,3720.061525,0,0.002353
n531,doc/Type/Attribute.pod,,3,6,9,95,0.416667,0.000931,3,6,9,7,0.27253,0.294334,8.88033,0,0.00064
n532,doc/Language/control.pod,,8,76,84,95,0.277826,0.01528,14,104,118,6,0.343787,0.401577,1134.317511,0,0.002302
n533,doc/Language/faq.pod,,11,44,55,95,0.274411,0.010118,17,60,77,6,0.358398,0.400893,1793.500031,0,0.001683
n534,doc/Type/DateTime.pod,,6,2,8,95,0.303571,0.00135,9,2,11,7,0.281451,0.307523,19.514849,0,0.000397
n535,doc/Language/syntax.pod,,17,13,30,95,0.256322,0.005028,20,14,34,6,0.333587,0.367636,429.905719,0,0.001148
n536,doc/Language/functions.pod,,10,86,96,95,0.240132,0.018265,18,134,152,6,0.374786,0.43512,4920.178694,0,0.002555
n537,doc/Language/nativecall.pod,,7,38,45,95,0.30404,0.007784,11,42,53,7,0.285111,0.329093,80.523442,0,0.001324
n538,doc/Language/quoting.pod,,9,23,32,95,0.38004,0.005256,11,23,34,7,0.283911,0.321776,38.238259,0,0.001007
n539,doc/Type/Iterator.pod,,8,18,26,95,0.5,0.004279,8,18,26,7,0.28263,0.316835,0,0,0.000825
n540,doc/Type/Metamodel/ClassHOW.pod,,23,25,48,95,0.304078,0.007971,30,26,56,7,0.284925,0.329948,1787.916753,0,0.001593
n541,doc/Type/Seq.pod,,28,18,46,95,0.328019,0.007822,36,18,54,7,0.28474,0.328808,151.175459,0,0.001377
n542,doc/Type/X/Attribute/Package.pod,,14,12,26,95,0.5,0.004279,14,12,26,7,0.28263,0.316835,0,0,0.000825
n543,doc/Type/X/Composition/NotComposable.pod,,15,11,26,95,0.5,0.004279,15,11,26,7,0.28263,0.316835,0,0,0.000825
n544,doc/Type/X/ControlFlow.pod,,16,10,26,95,0.5,0.004279,16,10,26,7,0.28263,0.316835,0,0,0.000825
n545,doc/Type/X/Declaration/Scope.pod,,17,9,26,95,0.5,0.004279,17,9,26,7,0.28263,0.316835,0,0,0.000825
n546,doc/Type/X/Declaration/Scope/Multi.pod,,18,8,26,95,0.5,0.004279,18,8,26,7,0.28263,0.316835,0,0,0.000825
n547,doc/Type/X/Inheritance/Unsupported.pod,,19,7,26,95,0.5,0.004279,19,7,26,7,0.28263,0.316835,0,0,0.000825
n548,doc/Type/X/Method/InvalidQualifier.pod,,20,6,26,95,0.5,0.004279,20,6,26,7,0.28263,0.316835,0,0,0.000825
n549,doc/Type/X/Mixin/NotComposable.pod,,21,5,26,95,0.5,0.004279,21,5,26,7,0.28263,0.316835,0,0,0.000825
n550,doc/Type/X/NoDispatcher.pod,,22,4,26,95,0.5,0.004279,22,4,26,7,0.28263,0.316835,0,0,0.000825
n551,doc/Type/X/Placeholder/Block.pod,,23,3,26,95,0.5,0.004279,23,3,26,7,0.28263,0.316835,0,0,0.000825
n552,doc/Type/X/Role/Initialization.pod,,24,2,26,95,0.5,0.004279,24,2,26,7,0.28263,0.316835,0,0,0.000825
n553,doc/Type/X/Sequence/Deduction.pod,,25,1,26,95,0.5,0.004279,25,1,26,7,0.28263,0.316835,0,0,0.000825
n554,doc/Type/X/Syntax/Self/WithoutObject.pod,,26,0,26,95,0.5,0.004279,26,0,26,7,0.28263,0.316835,0,0,0.000825
n555,doc/Language/concurrency.pod,,3,52,55,95,0.451852,0.01174,3,58,61,6,0.339659,0.384664,796.531716,0,0.001544
n556,doc/Language/testing.pod,,15,45,60,95,0.398023,0.01377,19,52,71,6,0.368642,0.414025,840.495442,0,0.001614
n557,doc/Type/Junction.pod,,18,6,24,95,0.389493,0.005962,18,6,24,7,0.314901,0.354615,330.406581,0,0.00077
n558,doc/Type/Callable.pod,,26,49,75,95,0.328288,0.014409,54,72,126,6,0.342712,0.396636,500.828746,0,0.002011
n559,doc/Language/classtut.pod,,2,58,60,95,0.398023,0.01377,2,69,71,6,0.368642,0.414025,840.495442,0,0.001614
n560,doc/Language/5to6-nutshell.pod,,3,68,71,95,0.329175,0.014239,3,97,100,6,0.364505,0.41336,1595.883811,0,0.001971
n561,html/.htaccess,,15,2,17,95,0.345588,0.00275,17,5,22,6,0.330072,0.357374,42.644103,0,0.000786
n562,util/sync,,0,0,0,96,0,0,0,0,0,0,0,0,0,0,0
n563,doc/Type/Range.pod,,0,0,0,97,0,0,0,0,0,0,0,0,0,0,0
n564,doc/Language/variables.pod,,24,60,84,95,0.281268,0.016933,54,92,146,6,0.372874,0.428278,2707.141971,0,0.002247
n565,doc/Language/grammars.pod,,0,0,0,98,0,0,0,0,0,0,0,0,0,0,0
n566,doc/Language/5to6-perlop.pod,,2,12,14,95,0.340659,0.002368,6,16,22,7,0.279388,0.307941,8.173809,0,0.00056
n567,doc/Language/subscripts.pod,,20,55,75,95,0.324865,0.014372,36,74,110,6,0.342578,0.396446,544.551423,0,0.002027
n568,doc/Type/Block.pod,,16,1,17,95,0.242647,0.00235,16,1,17,7,0.279745,0.309841,146.395942,0,0.000872
n569,doc/Type/Blob.pod,,7,1,8,95,0.5,0.000688,7,1,8,7,0.271181,0.290913,0,0,0.00061
n570,STYLEGUIDE.md,,1,0,1,144,0,0.000654,1,0,1,7,0.291653,0.307998,0,0,0.000187
n571,doc/Type/IO/Socket/INET.pod,,1,0,1,95,0,0.000245,1,0,1,7,0.271097,0.288158,0,0,0.000183
n572,doc/Type/X/AdHoc.pod,,0,0,0,99,0,0,0,0,0,0,0,0,0,0,0
n573,doc/Type/Promise.pod,,40,16,56,95,0.444481,0.011872,49,19,68,6,0.339922,0.385424,100.559842,0,0.001527
n574,doc/Type/IO.pod,,30,34,64,95,0.392113,0.013058,42,39,81,6,0.340847,0.389795,221.026861,0,0.001708
n575,doc/Language/exceptions.pod,,6,46,52,95,0.480769,0.011299,8,46,54,6,0.339134,0.382763,876,0,0.001532
n576,doc/Language/io.pod,,6,12,18,95,0.379085,0.003161,9,17,26,6,0.331318,0.359654,53.870119,0,0.000712
n577,doc/HomePage.pod,,1,4,5,95,0.35,0.001462,1,4,5,7,0.324095,0.349978,10.287318,0,0.000312
n578,doc/Language/containers.pod,,7,58,65,95,0.38726,0.013254,8,74,82,6,0.341245,0.390745,231.552829,0,0.001745
n579,doc/Type/Signature.pod,,72,14,86,95,0.268536,0.017045,125,19,144,6,0.373191,0.429418,4000.747562,0,0.002457
n580,util/missing-types.p6,,0,0,0,100,0,0,0,0,0,0,0,0,0,0,0
n581,doc/Type/Supplier.pod,,14,3,17,95,0.400735,0.003152,15,4,19,7,0.279122,0.308739,279.122708,0,0.000655
n582,doc/Type/Parameter.pod,,22,5,27,95,0.5,0.005518,22,5,27,7,0.282995,0.317975,0,0,0.000814
n583,doc/Language/packages.pod,,1,1,2,95,0.5,0.000408,1,1,2,7,0.273124,0.29384,0,0,0.000216
n584,doc/Type/Any.pod,,0,1,1,95,0,0.000259,0,1,1,7,0.271854,0.289583,0,0,0.000182
n585,doc/Type/X/Proc/Async/TapBeforeSpawn.pod,,0,0,0,101,0,0,0,0,0,0,0,0,0,0,0
n586,doc/Type/Grammar.pod,,0,2,2,95,0.5,0.000212,0,2,2,8,0.221857,0.23901,0,0,0.000324
n587,doc/Type/Positional.pod,,2,0,2,95,0.5,0.000212,2,0,2,8,0.221857,0.23901,0,0,0.000324
n588,doc/Language/mop.pod,,8,12,20,95,0.363158,0.003691,10,12,22,6,0.33182,0.361174,99.152108,0,0.000745
n589,doc/Type/IO/Socket.pod,,30,21,51,95,0.5,0.011247,31,21,52,6,0.339003,0.382193,0,0,0.001379
n590,doc/Language/phasers.pod,,1,1,2,95,0,0.00035,2,1,3,7,0.255834,0.274931,0.05,0,0.000207
n591,doc/Language/about.pod,,4,4,8,95,0.303571,0.001309,4,4,8,6,0.326995,0.349297,45.098883,0,0.000418
n592,doc/Type/Date.pod,,17,17,34,95,0.409982,0.00672,18,21,39,7,0.283727,0.322156,13.673158,0,0.001001
n593,generate-site.p6,,0,8,8,95,0.5,0.000519,0,8,8,6,0.25726,0.271323,0,0,0.000925
n594,lib/DocSite/Document.pm,,1,7,8,95,0.5,0.000519,1,7,8,6,0.25726,0.271323,0,0,0.000925
n595,lib/DocSite/Document/Registry.pm,,2,6,8,95,0.5,0.000519,2,6,8,6,0.25726,0.271323,0,0,0.000925
n596,lib/DocSite/Generator.pm,,5,5,10,95,0.322222,0.000624,5,5,10,6,0.257411,0.272463,1750,0,0.001312
n597,lib/DocSite/Pod/To/HTML.pm,,5,8,13,95,0.25641,0.001143,5,8,13,6,0.326995,0.349791,2993.080833,0,0.001292
n598,lib/DocSite/Type.pm,,5,3,8,95,0.5,0.000519,5,3,8,6,0.25726,0.271323,0,0,0.000925
n599,lib/DocSite/TypeGraph.pm,,6,2,8,95,0.5,0.000519,6,2,8,6,0.25726,0.271323,0,0,0.000925
n600,lib/DocSite/TypeGraph/Viz.pm,,7,1,8,95,0.5,0.000519,7,1,8,6,0.25726,0.271323,0,0,0.000925
n601,doc/index.html,,0,0,0,102,0,0,0,0,0,0,0,0,0,0,0
n602,lib/DocSite/Documentable.pm,,0,2,2,95,0.5,0.000118,0,2,2,7,0.204811,0.212122,0,0,0.00047
n603,lib/DocSite/Documentable/Registry.pm,,1,1,2,95,0.5,0.000118,1,1,2,7,0.204811,0.212122,0,0,0.00047
n604,doc/Type/Dateish.pod,,28,29,57,95,0.424185,0.011881,35,33,68,6,0.339922,0.385804,368.016782,0,0.001604
n605,doc/Language/glossary.pod,,12,48,60,95,0.263842,0.010624,18,64,82,6,0.337958,0.3855,1559.707637,0,0.001923
n606,doc/Language/rb-nutshell.pod,,0,0,0,103,0,0,0,0,0,0,0,0,0,0,0
n607,doc/Type/Slip.pod,,56,14,70,95,0.34265,0.013691,72,15,87,6,0.34191,0.393596,470.124506,0,0.001957
n608,doc/Type/Pair.pod,,22,6,28,95,0.48545,0.005745,23,6,29,7,0.283086,0.318545,0.617242,0,0.000838
n609,doc/Type/Temporal.pod,,0,0,0,104,0,0,0,0,0,0,0,0,0,0,0
n610,doc/Type/Iterable.pod,,0,1,1,130,0,0.000052,0,1,1,1,1,1,0,20,0.001053
n611,doc/Type/Scalar.pod,,23,4,27,95,0.5,0.005518,24,4,28,7,0.282995,0.317975,0,0,0.000814
n612,doc/Type/Exception.pod,,1,0,1,95,0,0.000189,1,0,1,7,0.253322,0.268374,0,0,0.000183
n613,doc/Language/setbagmix.pod,,3,1,4,95,0.416667,0.00072,3,1,4,7,0.276047,0.296919,0.22836,0,0.000269
n614,doc/Language/contributors.pod,,0,1,1,95,0,0.00019,0,1,1,7,0.252665,0.268849,0,0,0.000185
n615,doc/Language/unicode_entry.pod,,20,40,60,95,0.403107,0.012304,25,53,78,6,0.34045,0.387704,252.451625,0,0.001648
n616,doc/Language/unicode_texas.pod,,0,0,0,105,0,0,0,0,0,0,0,0,0,0,0
n617,doc/Language/list.pod,,12,59,71,95,0.338028,0.013843,17,79,96,6,0.342044,0.394166,488.317259,0,0.001982
n618,doc/Type/Stash.pod,,0,0,0,106,0,0,0,0,0,0,0,0,0,0,0
n619,doc/Type/Duration.pod,,1,0,1,107,0,0.000052,1,0,1,1,1,1,0,19,0.001053
n620,doc/Language/5to6-perlsyn.pod,,3,15,18,95,0.366013,0.003102,7,21,28,6,0.330196,0.357944,144.566449,0,0.000712
n621,doc/Language/modules-extra.pod,,2,4,6,95,0.5,0.001132,2,5,7,7,0.280461,0.304672,0,0,0.000323
n622,doc/Language/terms.pod,,0,0,0,108,0,0,0,0,0,0,0,0,0,0,0
n623,doc/Type/Metamodel/AttributeContainer.pod,,3,5,8,95,0.5,0.001208,3,5,8,6,0.295684,0.318738,0,0,0.000432
n624,doc/Type/X/Channel/ReceiveOnClosed.pod,,5,3,8,95,0.5,0.001208,5,3,8,6,0.295684,0.318738,0,0,0.000432
n625,doc/Type/X/Channel/SendOnClosed.pod,,6,2,8,95,0.5,0.001208,6,2,8,6,0.295684,0.318738,0,0,0.000432
n626,doc/Type/Channel.pod,,25,32,57,95,0.436717,0.012049,28,41,69,6,0.340054,0.385994,103.796077,0,0.001553
n627,doc/Type/IO/Spec/Unix.pod,,16,9,25,95,0.5,0.005056,19,10,29,7,0.282539,0.316265,0,0,0.000759
n628,doc/Type/IO/Spec/Win32.pod,,17,8,25,95,0.5,0.005056,21,8,29,7,0.282539,0.316265,0,0,0.000759
n629,doc/Type/NFC.pod,,0,5,5,95,0.5,0.000591,0,5,5,6,0.320073,0.33588,0,0,0.000472
n630,doc/Type/NFD.pod,,1,4,5,95,0.5,0.000591,1,6,7,6,0.320073,0.33588,0,0,0.000472
n631,doc/Type/NFKC.pod,,2,3,5,95,0.5,0.000591,3,5,8,6,0.320073,0.33588,0,0,0.000472
n632,doc/Type/NFKD.pod,,3,2,5,95,0.5,0.000591,6,3,9,6,0.320073,0.33588,0,0,0.000472
n633,doc/Type/Uni.pod,,49,7,56,95,0.419156,0.011694,50,7,57,6,0.351785,0.396161,883.758868,0,0.001743
n634,doc/Language/performance.pod,,21,50,71,95,0.336419,0.013732,29,64,93,6,0.342311,0.394546,346.70056,0,0.001953
n635,doc/Language/typesystem.pod,,17,44,61,95,0.384973,0.013826,23,50,73,6,0.368952,0.414785,1057.809764,0,0.001715
n636,doc/Type/Regex.pod,,39,12,51,95,0.5,0.011247,39,12,51,6,0.339003,0.382193,0,0,0.001379
n637,doc/Type/Semaphore.pod,,24,2,26,95,0.490769,0.005308,24,2,26,7,0.282812,0.317215,0.441243,0,0.000784
n638,doc/Type/Tap.pod,,0,0,0,109,0,0,0,0,0,0,0,0,0,0,0
n639,doc/Type/Real.pod,,0,0,0,110,0,0,0,0,0,0,0,0,0,0,0
n640,doc/Type/Variable.pod,,1,2,3,95,0.166667,0.000483,1,2,3,6,0.321128,0.33664,15.649215,0,0.000358
n641,doc/Type/Complex.pod,,8,13,21,95,0.435714,0.005331,8,13,21,7,0.313326,0.350909,368.953114,0,0.000737
n642,doc/Type/Bag.pod,,4,4,8,95,0.5,0.000688,4,4,8,7,0.271181,0.290913,0,0,0.00061
n643,doc/Type/Submethod.pod,,0,0,0,111,0,0,0,0,0,0,0,0,0,0,0
n644,doc/Type/IO/Special.pod,,33,20,53,95,0.474238,0.011498,36,20,56,6,0.339265,0.383333,19.56838,0,0.001434
n645,doc/Type/Instant.pod,,33,18,51,95,0.5,0.011247,33,18,51,6,0.339003,0.382193,0,0,0.001379
n646,doc/Type/Order.pod,,39,17,56,95,0.444481,0.011872,46,20,66,6,0.339922,0.385424,100.559842,0,0.001527
n647,doc/Type/X/IO/Symlink.pod,,0,0,0,112,0,0,0,0,0,0,0,0,0,0,0
n648,doc/Type/IO/Notification.pod,,28,23,51,95,0.5,0.011247,28,23,51,6,0.339003,0.382193,0,0,0.001379
n649,doc/Type/X/IO/Move.pod,,0,0,0,113,0,0,0,0,0,0,0,0,0,0,0
n650,doc/Type/X/Promise/Vowed.pod,,48,3,51,95,0.5,0.011247,48,3,51,6,0.339003,0.382193,0,0,0.001379
n651,doc/Type/X/Seq/Consumed.pod,,49,3,52,95,0.483032,0.011461,49,3,52,6,0.351221,0.393881,210.508945,0,0.001425
n652,doc/Type/Metamodel/Primitives.pod,,0,0,0,114,0,0,0,0,0,0,0,0,0,0,0
n653,doc/Type/BagHash.pod,,5,4,9,95,0.388889,0.000756,5,4,9,7,0.271433,0.291863,7.109718,0,0.000655
n654,doc/Type/AST.pod,,0,8,8,95,0.5,0.000688,0,8,8,7,0.271181,0.290913,0,0,0.00061
n655,doc/Type/Backtrace.pod,,3,5,8,95,0.5,0.000688,3,5,8,7,0.271181,0.290913,0,0,0.00061
n656,doc/Type/Baggy.pod,,6,2,8,95,0.5,0.000688,6,2,8,7,0.271181,0.290913,0,0,0.00061
n657,doc/Type/Thread.pod,,44,7,51,95,0.5,0.011247,44,7,51,6,0.339003,0.382193,0,0,0.001379
n658,doc/Type/WhateverCode.pod,,59,5,64,95,0.397073,0.013164,73,5,78,6,0.341112,0.390175,221.303803,0,0.001711
n659,doc/Type/X/Inheritance/NotComposed.pod,,47,4,51,95,0.5,0.011247,47,4,51,6,0.339003,0.382193,0,0,0.001379
n660,doc/Type/X/Temporal/InvalidFormat.pod,,0,0,0,115,0,0,0,0,0,0,0,0,0,0,0
n661,doc/Perl6/debugging.pod,,0,1,1,116,0,0.000052,0,1,1,1,1,1,0,21,0.001053
n662,doc/Perl6/hacking.pod,,1,0,1,116,0,0.000052,1,0,1,1,1,1,0,21,0.001053
n663,doc/Perl6/other-progs.pod,,0,0,0,117,0,0,0,0,0,0,0,0,0,0,0
n664,doc/Perl6/01-debugging.pod,,0,0,0,118,0,0,0,0,0,0,0,0,0,0,0
n665,doc/Perl6/00-running.pod,,0,0,0,119,0,0,0,0,0,0,0,0,0,0,0
n666,doc/Perl6/README.md,,0,0,0,120,0,0,0,0,0,0,0,0,0,0,0
n667,doc/Type/ComplexStr.pod,,9,10,19,95,0.5,0.005068,9,19,28,7,0.313102,0.349769,0,0,0.000626
n668,doc/Type/IntStr.pod,,12,7,19,95,0.5,0.005068,15,13,28,7,0.313102,0.349769,0,0,0.000626
n669,doc/Type/NumStr.pod,,16,3,19,95,0.5,0.005068,22,6,28,7,0.313102,0.349769,0,0,0.000626
n670,doc/Type/RatStr.pod,,18,1,19,95,0.5,0.005068,27,1,28,7,0.313102,0.349769,0,0,0.000626
n671,doc/Type/Mix.pod,,0,1,1,121,0,0.000052,0,1,1,1,1,1,0,22,0.001053
n672,doc/Type/MixHash.pod,,1,0,1,121,0,0.000052,1,0,1,1,1,1,0,22,0.001053
n673,doc/Type/X/Caller/NotDynamic.pod,,1,1,2,95,0.5,0.000274,1,1,2,6,0.311878,0.323736,0,0,0.000306
n674,doc/Type/Rational.pod,,1,1,2,95,0.5,0.000197,1,1,2,8,0.240406,0.257767,0,0,0.000221
n675,doc/Type/Lock.pod,,21,5,26,95,0.396923,0.006405,21,5,26,7,0.314788,0.355185,174.718581,0,0.000798
n676,doc/Type/Rat.pod,,17,4,21,95,0.416667,0.00521,17,4,21,7,0.313326,0.350909,677.768516,0,0.00075
n677,doc/Type/X/IO/DoesNotExist.pod,,0,1,1,95,0,0.000217,0,1,1,6,0.311656,0.322976,0,0,0.000204
n678,Configure.p6,,2,0,2,95,0.5,0.000255,2,0,2,6,0.28109,0.292094,0,0,0.000252
n679,doc/Type/X/DateTime/TimezoneClash.pod,,0,0,0,122,0,0,0,0,0,0,0,0,0,0,0
n680,doc/Type/Version.pod,,0,0,0,123,0,0,0,0,0,0,0,0,0,0,0
n681,doc/Type/Stringy.pod,,0,0,0,124,0,0,0,0,0,0,0,0,0,0,0
n682,doc/Type/CurrentThreadScheduler.pod,,2,3,5,95,0.5,0.000935,3,5,8,7,0.264715,0.286675,0,0,0.000309
n683,doc/Type/Metamodel/MultipleInheritance.pod,,1,1,2,95,0.5,0.000265,1,1,2,7,0.260547,0.276223,0,0,0.000236
n684,doc/Type/X/IO/Link.pod,,0,1,1,95,0,0.000217,0,1,1,6,0.311656,0.322976,0,0,0.000204
n685,doc/Type/Capture.pod,,14,13,27,95,0.5,0.005518,14,13,27,7,0.282995,0.317975,0,0,0.000814
n686,doc/404.pod,,0,2,2,95,0.5,0.000422,0,2,2,6,0.32101,0.337704,0,0,0.000237
n687,doc/Type/Num.pod,,0,0,0,125,0,0,0,0,0,0,0,0,0,0,0
n688,doc/Type/Cancellation.pod,,0,0,0,126,0,0,0,0,0,0,0,0,0,0,0
n689,doc/Type/Metamodel/MethodContainer.pod,,0,0,0,127,0,0,0,0,0,0,0,0,0,0,0
n690,doc/Programs/00-running.pod,,0,0,0,128,0,0,0,0,0,0,0,0,0,0,0
n691,doc/Programs/01-debugging.pod,,0,0,0,129,0,0,0,0,0,0,0,0,0,0,0
n692,doc/Programs/README.md,,50,52,102,136,0.31955,0.322731,55,52,107,7,0.360609,0.450206,27559.369095,0,0.001172
n693,doc/Type/QuantHash.pod,,1,0,1,130,0,0.000052,1,0,1,1,1,1,0,20,0.001053
n694,doc/Type/Setty.pod,,0,0,0,131,0,0,0,0,0,0,0,0,0,0,0
n695,template/type-graph.html,,2,0,2,95,0.5,0.000425,4,0,4,6,0.325176,0.341809,0,0,0.000256
n696,doc/Type/Mixy.pod,,30,11,41,95,0.401829,0.0079,39,13,52,7,0.284555,0.326527,12.881518,0,0.001158
n697,t/tabs.t,,7,11,18,144,0.460784,0.003337,14,40,54,6,0.308044,0.335044,18.628495,0,0.000846
n698,doc/Type/PositionalBindFailover.pod,,22,3,25,95,0.5,0.005056,22,3,25,7,0.282539,0.316265,0,0,0.000759
n699,doc/Type/Whatever.pod,,14,1,15,95,0.5,0.002995,14,1,15,7,0.278944,0.307599,0,0,0.000534
n700,t/trailing_whitespace.t,,2,0,2,136,0.5,0.008238,2,0,2,8,0.262969,0.305164,0,0,0.000169
n701,doc/Type/Match.pod,,0,0,0,132,0,0,0,0,0,0,0,0,0,0,0
n702,html/images/Camelia.svg,,0,0,0,133,0,0,0,0,0,0,0,0,0,0,0
n703,app-start,,2,3,5,95,0.5,0.001004,2,3,5,6,0.315014,0.331281,0,0,0.000439
n704,assets/sass/style.scss,,7,11,18,95,0.163399,0.002135,7,50,57,6,0.347464,0.371076,2330.625844,0,0.001601
n705,doc/Language/5to6-perlop.pod6,,8,190,198,136,0.423371,0.765704,18,310,328,6,0.425522,0.528221,40892.362934,0,0.001522
n706,html/js/jquery.cookie.js,,3,2,5,95,0.5,0.000459,3,2,5,6,0.299215,0.314006,0,0,0.000477
n707,doc/Language/rb-nutshell.pod6,,41,150,191,136,0.453265,0.763801,118,216,334,7,0.354917,0.478237,201.322478,0,0.001198
n708,doc/Language/typesystem.pod6,,50,165,215,136,0.397109,0.822947,231,296,527,7,0.356359,0.489355,954.147718,0,0.001397
n709,doc/Language/quoting.pod6,,40,166,206,136,0.425669,0.811653,170,309,479,7,0.352492,0.482589,177.429602,0,0.001267
n710,doc/Language/operators.pod6,,33,174,207,136,0.421017,0.810498,146,369,515,7,0.357521,0.48774,283.737163,0,0.001296
n711,doc/Language/grammars.pod6,,21,170,191,136,0.455001,0.765596,80,301,381,7,0.35038,0.474038,131.7075,0,0.001189
n712,doc/Type/Date.pod6,,83,162,245,136,0.373402,0.92399,168,372,540,7,0.347878,0.496253,161.970504,0,0.001481
n713,doc/Type/IO/Path.pod6,,76,174,250,136,0.308112,0.834084,167,330,497,7,0.3639,0.512255,2113.176778,0,0.001627
n714,doc/Language/5to6-perlfunc.pod6,,4,189,193,136,0.446001,0.765099,9,351,360,7,0.358398,0.482799,470.206474,0,0.001256
n715,doc/Language/traps.pod6,,50,145,195,136,0.438964,0.767827,185,215,400,7,0.358691,0.483939,492.396135,0,0.001277
n716,doc/Language/control.pod6,,13,193,206,136,0.424414,0.809816,43,385,428,7,0.35723,0.486979,250.450909,0,0.001281
n717,doc/Type/Baggy.pod6,,67,174,241,136,0.377351,0.912182,99,337,436,7,0.347327,0.493973,302.703722,0,0.001472
n718,t/pod6.t,,6,12,18,144,0.460784,0.003337,9,37,46,6,0.308044,0.335044,18.628495,0,0.000846
n719,doc/Language/list.pod6,,26,181,207,136,0.421369,0.810896,106,378,484,7,0.352634,0.48316,578.611611,0,0.001338
n720,t/type-graph.t,,0,0,0,134,0,0,0,0,0,0,0,0,0,0,0
n721,doc/Language/variables.pod6,,55,154,209,136,0.415302,0.813668,263,266,529,7,0.357521,0.4885,526.254952,0,0.001327
n722,doc/Language/functions.pod6,,18,189,207,136,0.422189,0.811651,73,466,539,7,0.357376,0.48755,262.927187,0,0.001287
n723,doc/Type/Version.pod6,,194,51,245,136,0.374205,0.924288,409,59,468,7,0.358105,0.504824,402.778572,0,0.001484
n724,doc/Language/phasers.pod6,,36,138,174,136,0.486812,0.707578,67,153,220,7,0.342712,0.460165,119.33326,0,0.001113
n725,doc/Type/Cool.pod6,,82,213,295,136,0.302122,1,213,462,675,7,0.370668,0.537721,2918.779628,0,0.001978
n726,doc/Type/List.pod6,,119,134,253,136,0.361331,0.94014,356,306,662,7,0.359279,0.509385,816.151757,0,0.001575
n727,doc/Language/testing.pod6,,50,143,193,136,0.444435,0.76378,150,193,343,7,0.358105,0.482418,512.61615,0,0.001272
n728,doc/Type/Callable.pod6,,73,186,259,136,0.327332,0.90925,104,296,400,7,0.35463,0.508815,1167.716561,0,0.001611
n729,doc/Programs/00-running.pod6,,56,138,194,136,0.439133,0.762364,110,170,280,6,0.405455,0.510585,28414.158367,0,0.001291
n730,doc/Language/packages.pod6,,34,139,173,136,0.491464,0.706732,82,180,262,7,0.342177,0.459024,61.480905,0,0.001093
n731,doc/Type/Capture.pod6,,75,214,289,136,0.311419,0.993837,130,400,530,7,0.354057,0.521339,861.936549,0,0.001758
n732,doc/Language/unicode_texas.pod6,,47,41,88,136,0.481191,0.350469,132,44,176,7,0.336273,0.414935,10.995069,0,0.000637
n733,doc/Type/Pair.pod6,,143,100,243,136,0.375982,0.918649,307,198,505,7,0.347602,0.495113,178.180488,0,0.001469
n734,doc/Type/Signature.pod6,,174,73,247,136,0.367072,0.923373,446,117,563,7,0.3615,0.508549,770.619252,0,0.001544
n735,doc/Type/Mu.pod6,,136,114,250,136,0.366474,0.934686,335,225,560,7,0.358838,0.507675,467.889564,0,0.001514
n736,doc/Type/Any.pod6,,62,233,295,136,0.301015,0.998553,154,643,797,7,0.373828,0.540761,3711.716414,0,0.001921
n737,doc/Type/Num.pod6,,140,103,243,136,0.377717,0.920716,263,159,422,7,0.357813,0.503684,381.616329,0,0.001471
n738,doc/Type/Str.pod6,,181,73,254,136,0.359092,0.941002,538,118,656,7,0.364354,0.514345,798.468792,0,0.001583
n739,doc/Type/Code.pod6,,79,177,256,136,0.354442,0.94288,154,367,521,7,0.359721,0.511096,622.281314,0,0.001557
n740,doc/Language/syntax.pod6,,46,161,207,136,0.421392,0.811696,194,296,490,7,0.358838,0.488785,433.221158,0,0.001295
n741,doc/Language/5to6-nutshell.pod6,,2,190,192,136,0.450453,0.764803,3,397,400,7,0.355061,0.478808,211.4379,0,0.001213
n742,doc/Language/modules.pod6,,31,162,193,136,0.442789,0.761382,117,296,413,7,0.358545,0.482989,587.181047,0,0.001287
n743,doc/Type/Promise.pod6,,156,93,249,136,0.366531,0.931286,375,192,567,7,0.348431,0.498534,209.287033,0,0.001506
n744,doc/Language/performance.pod6,,35,155,190,136,0.4599,0.765551,116,256,372,7,0.35024,0.473467,115.11071,0,0.001174
n745,doc/Type/X/Mixin/NotComposable.pod6,,37,43,80,135,0.493987,0.185966,38,43,81,8,0.280281,0.370291,0.757651,0,0.000629
n746,test-links.sh,,1,0,1,95,0,0.000099,1,0,1,7,0.271685,0.282703,0,0,0.000223
n747,doc/Type/Iterable.pod6,,109,129,238,136,0.384374,0.90825,176,230,406,7,0.346915,0.492263,137.15635,0,0.001439
n748,doc/Type/Hash.pod6,,93,145,238,136,0.384374,0.90825,206,299,505,7,0.346915,0.492263,137.15635,0,0.001439
n749,doc/Type/X/Eval/NoSuchLang.pod6,,20,60,80,135,0.490823,0.185342,20,65,85,8,0.278855,0.368144,1.765292,0,0.000629
n750,doc/Type/X/IO/Dir.pod6,,45,60,105,135,0.467491,0.275888,61,110,171,8,0.283727,0.386559,6.954534,0,0.000771
n751,doc/Type/X/IO/Link.pod6,,47,58,105,135,0.467491,0.275888,66,105,171,8,0.283727,0.386559,6.954534,0,0.000771
n752,doc/Type/X/IO/Rmdir.pod6,,51,54,105,135,0.467491,0.275888,75,96,171,8,0.283727,0.386559,6.954534,0,0.000771
n753,doc/Type/X/IO/Unlink.pod6,,53,52,105,135,0.467491,0.275888,80,91,171,8,0.283727,0.386559,6.954534,0,0.000771
n754,doc/Type/X/Placeholder/Mainline.pod6,,75,30,105,135,0.467491,0.275888,119,52,171,8,0.283727,0.386559,6.954534,0,0.000771
n755,doc/Type/Tap.pod6,,178,62,240,136,0.380561,0.912321,267,78,345,7,0.347189,0.493403,163.116465,0,0.001451
n756,template/examples.html,,1,0,1,95,0,0.000334,1,0,1,6,0.320893,0.337134,0,0,0.000198
n757,doc/Type/Metamodel/C3MRO.pod6,,83,50,133,136,0.466393,0.547424,113,72,185,7,0.342177,0.44059,67.725659,0,0.000873
n758,doc/Type/IO.pod6,,96,165,261,136,0.342411,0.944601,274,408,682,7,0.365569,0.518526,1641.210017,0,0.001697
n759,doc/Language/terms.pod6,,47,141,188,136,0.463733,0.758569,153,193,346,7,0.34996,0.472327,112.202096,0,0.001162
n760,doc/Language/glossary.pod6,,19,190,209,136,0.414681,0.812922,90,423,513,7,0.357813,0.48888,325.349538,0,0.001318
n761,doc/Type/Int.pod6,,109,141,250,136,0.366474,0.934686,235,308,543,7,0.358838,0.507675,467.889564,0,0.001514
n762,doc/Type/Bool.pod6,,71,172,243,136,0.374656,0.916987,109,351,460,7,0.359426,0.504463,552.215147,0,0.001497
n763,doc/Type/Map.pod6,,117,121,238,136,0.384374,0.90825,178,200,378,7,0.346915,0.492263,137.15635,0,0.001439
n764,doc/Language/ipc.pod,,0,0,0,137,0,0,0,0,0,0,0,0,0,0,0
n765,doc/Language/ipc.pod6,,25,163,188,136,0.463733,0.758569,71,251,322,7,0.34996,0.472327,112.202096,0,0.001162
n766,doc/HomePage.pod6,,1,187,188,136,0.463733,0.758569,1,248,249,7,0.34996,0.472327,112.202096,0,0.001162
n767,doc/Language/mop.pod6,,30,158,188,136,0.463733,0.758569,94,235,329,7,0.34996,0.472327,112.202096,0,0.001162
n768,doc/Type/Proc.pod6,,158,98,256,136,0.357797,0.947324,372,196,568,7,0.359721,0.511096,512.635421,0,0.001551
n769,doc/Type/Proc/Async.pod6,,94,116,210,135,0.335407,0.69903,155,180,335,7,0.355925,0.487264,1655.312489,0,0.001392
n770,doc/Type/Method.pod6,,115,64,179,136,0.482644,0.729439,187,118,305,7,0.338741,0.458245,12.891084,0,0.001109
n771,doc/Language/classtut.pod6,,8,197,205,136,0.427714,0.808971,22,426,448,7,0.35235,0.482019,175.024325,0,0.001261
n772,doc/Language/regexes.pod6,,42,165,207,136,0.4209,0.81047,179,284,463,7,0.357376,0.48755,263.221574,0,0.001293
n773,doc/Language/tables.pod6,,46,143,189,136,0.459332,0.759043,121,183,304,7,0.35463,0.477097,181.939628,0,0.001186
n774,doc/Language/objects.pod6,,32,174,206,136,0.423893,0.80932,146,338,484,7,0.352492,0.482589,193.18642,0,0.001276
n775,doc/Type/IO/Pipe.pod6,,26,115,141,136,0.457042,0.540563,35,148,183,7,0.318215,0.42457,17.736169,0,0.00092
n776,doc/Type/Nil.pod6,,141,104,245,136,0.374205,0.924288,297,187,484,7,0.358105,0.504824,402.778572,0,0.001484
n777,t/00-load.t,,0,16,16,144,0.5,0.002611,0,16,16,6,0.299011,0.323147,0,0,0.000774
n778,doc/Language/faq.pod6,,19,190,209,136,0.413347,0.810977,73,447,520,7,0.360757,0.491921,668.879103,0,0.001362
n779,doc/Type/Block.pod6,,69,113,182,136,0.468976,0.73337,102,211,313,7,0.339396,0.460336,134.018779,0,0.001142
n780,doc/Type/Range.pod6,,160,89,249,136,0.366531,0.931286,355,178,533,7,0.348431,0.498534,209.287033,0,0.001506
n781,doc/Language/containers.pod6,,12,179,191,136,0.450785,0.760213,31,343,374,6,0.367253,0.486165,3445.114157,0,0.001237
n782,doc/Type/Scalar.pod6,,157,52,209,136,0.41544,0.813363,375,95,470,7,0.357667,0.48869,378.998314,0,0.001298
n783,doc/Type/Routine.pod6,,166,81,247,136,0.368306,0.925325,354,138,492,7,0.35066,0.499028,235.787478,0,0.001508
n784,doc/Type/CallFrame.pod6,,71,127,198,136,0.423499,0.775057,83,195,278,7,0.341511,0.469458,140.358698,0,0.001225
n785,predefined-search-items,,2,1,3,95,0.166667,0.004944,2,1,3,6,0.374306,0.399582,740.626769,0,0.000285
n786,doc/Language/concurrency.pod6,,10,196,206,136,0.425669,0.811653,30,389,419,7,0.352492,0.482589,177.429602,0,0.001267
n787,doc/Type/Instant.pod6,,108,137,245,136,0.374205,0.924288,203,252,455,7,0.358105,0.504824,402.778572,0,0.001484
n788,doc/Language/unicode_entry.pod6,,53,137,190,136,0.457059,0.761249,154,195,349,7,0.354917,0.477857,188.289853,0,0.001189
n789,doc/Type/Array.pod6,,61,228,289,136,0.309905,0.991866,88,506,594,7,0.366332,0.530689,1708.155218,0,0.001786
n790,doc/Type/Attribute.pod6,,65,190,255,136,0.354284,0.938568,146,449,595,7,0.366027,0.516151,1054.514325,0,0.001579
n791,doc/Type/Bag.pod6,,65,176,241,136,0.377351,0.912182,96,380,476,7,0.347327,0.493973,302.703722,0,0.001472
n792,doc/Type/BagHash.pod6,,66,116,182,136,0.468976,0.73337,82,205,287,7,0.339396,0.460336,134.018779,0,0.001142
n793,doc/Type/Junction.pod6,,102,79,181,136,0.47299,0.730383,152,141,293,7,0.339003,0.459385,60.225561,0,0.00114
n794,doc/Type/Metamodel/ClassHOW.pod6,,92,102,194,136,0.389482,0.734939,158,154,312,7,0.35052,0.475368,384.625169,0,0.001245
n795,doc/Type/Metamodel/MultipleInheritance.pod6,,45,38,83,136,0.498237,0.361947,61,46,107,8,0.281451,0.373807,0.161675,0,0.000595
n796,doc/Type/Mix.pod6,,129,109,238,136,0.384374,0.90825,258,206,464,7,0.346915,0.492263,137.15635,0,0.001439
n797,doc/Type/MixHash.pod6,,130,108,238,136,0.384374,0.90825,223,183,406,7,0.346915,0.492263,137.15635,0,0.001439
n798,doc/Type/Rat.pod6,,159,81,240,136,0.378609,0.909195,303,138,441,7,0.347189,0.493403,211.231603,0,0.00147
n799,doc/Type/Set.pod6,,169,71,240,136,0.378609,0.909195,370,109,479,7,0.347189,0.493403,211.231603,0,0.00147
n800,doc/Type/SetHash.pod6,,152,29,181,136,0.47299,0.730383,245,45,290,7,0.339003,0.459385,60.225561,0,0.00114
n801,doc/Type/Sub.pod6,,159,21,180,136,0.479299,0.731892,319,35,354,7,0.338872,0.458815,17.193197,0,0.001115
n802,doc/Type/Whatever.pod6,,182,17,199,136,0.435409,0.789152,368,20,388,7,0.341644,0.470028,55.109071,0,0.001224
n803,t/perl-nbsp.t,,0,0,0,138,0,0,0,0,0,0,0,0,0,0,0
n804,doc/Language/5to6-perlsyn.pod6,,5,184,189,136,0.459332,0.759043,17,287,304,7,0.35463,0.477097,181.939628,0,0.001186
n805,doc/Language/5to6-perlvar.pod6,,6,185,191,136,0.454781,0.765091,19,287,306,7,0.354917,0.478237,187.84778,0,0.001198
n806,doc/Language/contributors.pod6,,13,176,189,136,0.458882,0.75868,33,275,308,7,0.3501,0.472897,334.918327,0,0.001212
n807,doc/Language/exceptions.pod6,,15,173,188,136,0.463733,0.758569,49,357,406,7,0.34996,0.472327,112.202096,0,0.001162
n808,doc/Language/modules-extra.pod6,,28,160,188,136,0.463733,0.758569,69,226,295,7,0.34996,0.472327,112.202096,0,0.001162
n809,doc/Language/nativecall.pod6,,33,162,195,136,0.43825,0.767167,99,276,375,7,0.358838,0.484129,596.03673,0,0.001298
n810,doc/Language/setbagmix.pod6,,44,162,206,136,0.423609,0.809083,158,272,430,7,0.352492,0.482589,452.073809,0,0.00131
n811,doc/Language/subscripts.pod6,,44,161,205,136,0.427714,0.808971,214,306,520,7,0.35235,0.482019,175.024325,0,0.001261
n812,doc/Programs/01-debugging.pod6,,57,133,190,136,0.454497,0.759112,116,166,282,7,0.354773,0.477667,1057.939628,0,0.001325
n813,doc/Type/Cancellation.pod6,,75,183,258,136,0.330664,0.909795,127,228,355,7,0.360016,0.512236,1092.930923,0,0.001585
n814,doc/Type/IO/Socket/Async.pod6,,79,131,210,136,0.366986,0.772955,147,251,398,7,0.359132,0.490305,1046.122042,0,0.001359
n815,doc/Type/IO/Socket/INET.pod6,,79,163,242,135,0.322211,0.820275,140,276,416,7,0.357521,0.502924,1337.863066,0,0.001519
n816,doc/Type/Label.pod6,,112,162,274,136,0.317264,0.948964,236,287,523,7,0.368952,0.526983,1970.369646,0,0.0017
n817,doc/Type/Lock.pod6,,117,133,250,136,0.366474,0.934686,246,260,506,7,0.358838,0.507675,467.889564,0,0.001514
n818,doc/Type/Metamodel/AttributeContainer.pod6,,68,91,159,135,0.330905,0.514228,92,122,214,7,0.351785,0.461229,1275.734985,0,0.001087
n819,doc/Type/Metamodel/MethodContainer.pod6,,97,110,207,136,0.382065,0.780617,155,175,330,7,0.35235,0.482779,378.276899,0,0.001284
n820,doc/Type/Metamodel/PrivateMethodContainer.pod6,,60,19,79,136,0.498053,0.317251,61,19,80,7,0.334989,0.409613,1.048912,0,0.000588
n821,doc/Type/Metamodel/Trusting.pod6,,93,85,178,136,0.40332,0.67833,111,98,209,7,0.348292,0.466246,614.048655,0,0.001151
n822,doc/Type/Numeric.pod6,,145,104,249,136,0.366336,0.930375,309,195,504,7,0.365112,0.51273,827.630655,0,0.001536
n823,doc/Type/Rational.pod6,,167,87,254,136,0.359046,0.940973,371,149,520,7,0.359426,0.509955,578.926902,0,0.001558
n824,doc/Type/Stash.pod6,,163,29,192,136,0.454625,0.768887,289,43,332,7,0.35052,0.474608,135.142421,0,0.001186
n825,doc/Type/Supply.pod6,,186,72,258,136,0.352834,0.948268,515,111,626,7,0.360016,0.512236,652.112944,0,0.001582
n826,doc/Type/X/Bind/NativeType.pod6,,145,84,229,135,0.325711,0.764141,194,172,366,7,0.355637,0.495512,1275.867268,0,0.001443
n827,doc/Type/X/NYI.pod6,,126,44,170,135,0.329412,0.534428,162,81,243,7,0.347327,0.461875,973.378067,0,0.001126
n828,doc/Type/X/Obsolete.pod6,,183,46,229,135,0.325711,0.764141,282,97,379,7,0.355637,0.495512,1275.867268,0,0.001443
n829,doc/Type/X/Parameter/MultipleTypeConstraints.pod6,,134,37,171,135,0.329584,0.539069,178,68,246,7,0.347464,0.462445,974.753224,0,0.001131
n830,doc/Type/X/Syntax/Malformed.pod6,,221,19,240,135,0.320868,0.804341,376,41,417,7,0.35723,0.501784,1332.668161,0,0.001503
n831,doc/Type/X/Syntax/P5.pod6,,156,14,170,135,0.329412,0.534428,217,26,243,7,0.347327,0.461875,973.378067,0,0.001126
n832,util/extract-examples.p6,,31,2,33,136,0.369318,0.120961,49,2,51,7,0.327973,0.382494,347.940044,0,0.000453
n833,doc/Language/pragmas.pod6,,38,135,173,136,0.491834,0.707103,71,152,223,7,0.342311,0.459214,59.166913,0,0.00109
n834,doc/Type/Exception.pod6,,89,162,251,136,0.361291,0.93223,188,380,568,7,0.348708,0.499674,298.29724,0,0.001537
n835,doc/Type/Backtrace.pod6,,63,133,196,136,0.432104,0.772408,64,181,245,7,0.341245,0.468317,411.973042,0,0.001246
n836,doc/Type/Channel.pod6,,76,170,246,136,0.367247,0.920515,118,329,447,7,0.348016,0.496824,268.204752,0,0.001494
n837,doc/Type/Complex.pod6,,78,212,290,136,0.310643,0.995689,137,430,567,7,0.3542,0.521909,873.18113,0,0.001764
n838,doc/Type/CurrentThreadScheduler.pod6,,80,184,264,135,0.327356,0.926629,106,222,328,7,0.35052,0.507086,675.407992,0,0.001615
n839,doc/Type/DateTime.pod6,,84,160,244,136,0.373119,0.918998,163,354,517,7,0.34774,0.495683,213.669304,0,0.001485
n840,doc/Type/Grammar.pod6,,92,122,214,136,0.403383,0.825924,143,228,371,7,0.343652,0.47858,178.325787,0,0.001329
n841,doc/Type/Match.pod6,,118,125,243,136,0.375982,0.918649,195,228,423,7,0.347602,0.495113,178.180488,0,0.001469
n842,doc/Type/Metamodel/Primitives.pod6,,48,94,142,136,0.450804,0.540692,62,117,179,7,0.31833,0.42514,110.264677,0,0.000951
n843,doc/Type/Metamodel/RoleContainer.pod6,,49,93,142,136,0.450804,0.540692,65,114,179,7,0.31833,0.42514,110.264677,0,0.000951
n844,doc/Type/NFC.pod6,,118,73,191,136,0.448057,0.764222,132,90,222,7,0.340583,0.465467,55.397346,0,0.001176
n845,doc/Type/NFD.pod6,,119,72,191,136,0.448057,0.764222,135,89,224,7,0.340583,0.465467,55.397346,0,0.001176
n846,doc/Type/NFKC.pod6,,120,71,191,136,0.448057,0.764222,136,87,223,7,0.340583,0.465467,55.397346,0,0.001176
n847,doc/Type/NFKD.pod6,,121,70,191,136,0.448057,0.764222,141,84,225,7,0.340583,0.465467,55.397346,0,0.001176
n848,doc/Type/Proxy.pod6,,155,88,243,136,0.375982,0.918649,273,150,423,7,0.347602,0.495113,178.180488,0,0.001469
n849,doc/Type/Slip.pod6,,173,70,243,136,0.375982,0.918649,357,111,468,7,0.347602,0.495113,178.180488,0,0.001469
n850,doc/Type/Submethod.pod6,,159,33,192,136,0.44519,0.765842,185,39,224,7,0.340715,0.466037,57.614431,0,0.001182
n851,doc/Type/Supplier.pod6,,176,64,240,136,0.380561,0.912321,270,91,361,7,0.347189,0.493403,163.116465,0,0.001451
n852,doc/Type/Thread.pod6,,185,59,244,136,0.373119,0.918998,363,78,441,7,0.34774,0.495683,213.669304,0,0.001485
n853,doc/Type/ThreadPoolScheduler.pod6,,165,26,191,136,0.448057,0.764222,201,29,230,7,0.340583,0.465467,55.397346,0,0.001176
n854,doc/Type/Variable.pod6,,182,30,212,136,0.410266,0.824979,369,39,408,7,0.343383,0.477439,110.118699,0,0.001298
n855,doc/Type/X/AdHoc.pod6,,96,92,188,135,0.328166,0.602947,161,186,347,7,0.351221,0.472726,1270.845452,0,0.00126
n856,doc/Type/X/Assignment/RO.pod6,,100,44,144,136,0.446581,0.546952,128,55,183,7,0.319025,0.426679,59.373809,0,0.000951
n857,doc/Type/X/Bind.pod6,,64,71,135,135,0.368159,0.416133,71,74,145,8,0.286601,0.403852,85.277733,0,0.000938
n858,doc/Type/X/Bind/Slice.pod6,,48,73,121,135,0.367906,0.351982,49,81,130,8,0.283819,0.393286,46.331064,0,0.000848
n859,doc/Type/X/Channel/ReceiveOnClosed.pod6,,108,77,185,135,0.359342,0.609691,141,113,254,7,0.323378,0.449655,213.07186,0,0.001194
n860,doc/Type/X/Channel/SendOnClosed.pod6,,109,76,185,135,0.359342,0.609691,145,109,254,7,0.323378,0.449655,213.07186,0,0.001194
n861,doc/Type/X/Does/TypeObject.pod6,,143,74,217,135,0.336448,0.72178,240,157,397,7,0.328219,0.468963,411.554751,0,0.001373
n862,doc/Type/X/Inheritance/NotComposed.pod6,,128,57,185,135,0.359342,0.609691,169,84,253,7,0.323378,0.449655,213.07186,0,0.001194
n863,doc/Type/X/Proc/Async/AlreadyStarted.pod6,,53,7,60,136,0.459322,0.230472,58,10,68,8,0.278678,0.358908,8.819781,0,0.000494
n864,doc/Type/X/Proc/Async/CharsOrBytes.pod6,,132,18,150,136,0.429485,0.561673,179,23,202,7,0.319257,0.429701,55.404612,0,0.000978
n865,doc/Type/X/Proc/Async/MustBeStarted.pod6,,154,31,185,135,0.359342,0.609691,215,46,261,7,0.323378,0.449655,213.07186,0,0.001194
n866,doc/Type/X/Proc/Async/OpenForWriting.pod6,,106,26,132,135,0.355598,0.397105,118,28,146,8,0.285482,0.400793,61.550741,0,0.000907
n867,doc/Type/X/Proc/Async/TapBeforeSpawn.pod6,,156,29,185,135,0.359342,0.609691,213,40,253,7,0.323378,0.449655,213.07186,0,0.001194
n868,doc/Language/about.pod6,,7,247,254,136,0.329993,0.893674,12,329,341,7,0.351503,0.502639,1627.979603,0,0.001643
n869,doc/Type/Setty.pod6,,173,72,245,136,0.369605,0.918375,347,117,464,7,0.359721,0.505604,733.251956,0,0.001524
n870,doc/Type/X/Anon/Augment.pod6,,28,90,118,135,0.409315,0.314791,66,158,224,7,0.337437,0.429435,913.950619,0,0.000886
n871,doc/Type/X/Proc/Async.pod6,,119,21,140,136,0.44332,0.526663,166,29,195,7,0.344597,0.44536,387.278298,0,0.000961
n872,doc/Type/X/Syntax/Regex/Adverb.pod6,,165,16,181,135,0.363444,0.589142,247,20,267,7,0.3501,0.468545,971.366243,0,0.001215
n873,doc/Type/X/TypeCheck/Assignment.pod6,,9,0,9,136,0.5,0.027658,9,0,9,8,0.272954,0.327969,0,0,0.00021
n874,doc/Type/RatStr.pod6,,146,42,188,136,0.455114,0.751373,288,97,385,7,0.351503,0.473106,231.389871,0,0.00119
n875,doc/Language/experimental.pod6,,16,156,172,136,0.4966,0.706258,34,214,248,7,0.337827,0.454254,1.314558,0,0.00107
n876,doc/Type/Blob.pod6,,68,220,288,136,0.311484,0.99081,95,426,521,7,0.358545,0.524969,1310.549883,0,0.001779
n877,doc/Type/X/Placeholder/Block.pod6,,78,32,110,135,0.436614,0.292322,118,55,173,8,0.284187,0.389409,57.062799,0,0.000813
n878,doc/Type/X/TypeCheck/Binding.pod6,,8,0,8,136,0.5,0.029265,8,0,8,8,0.265275,0.320481,0,0,0.000202
n879,doc/Type/ComplexStr.pod6,,79,108,187,136,0.451153,0.743131,131,220,351,7,0.339791,0.462806,98.767808,0,0.001163
n880,doc/Type/IO/Spec/Cygwin.pod6,,37,105,142,136,0.421586,0.517489,56,144,200,7,0.324214,0.431126,298.144995,0,0.00101
n881,doc/Type/X/ControlFlow.pod6,,14,6,20,136,0.5,0.074428,14,6,20,8,0.274663,0.335323,0,0,0.00027
n882,doc/Type/X/IO/Chdir.pod6,,41,53,94,135,0.452986,0.257569,49,57,106,8,0.28263,0.380097,12.472803,0,0.000708
n883,doc/Type/X/IO/Chmod.pod6,,42,52,94,135,0.452986,0.257569,51,55,106,8,0.28263,0.380097,12.472803,0,0.000708
n884,doc/Type/X/IO/Copy.pod6,,43,51,94,135,0.452986,0.257569,53,53,106,8,0.28263,0.380097,12.472803,0,0.000708
n885,doc/Type/X/IO/Cwd.pod6,,44,50,94,135,0.452986,0.257569,55,51,106,8,0.28263,0.380097,12.472803,0,0.000708
n886,doc/Type/X/Syntax/Confused.pod6,,118,18,136,135,0.36024,0.431924,145,19,164,7,0.318446,0.422593,160.580128,0,0.000935
n887,doc/Type/X/Anon/Multi.pod6,,92,91,183,135,0.368252,0.591716,105,183,288,7,0.323616,0.448914,202.909249,0,0.001188
n888,doc/Type/X/Attribute/NoPackage.pod6,,118,89,207,135,0.344777,0.685782,159,187,346,7,0.326995,0.463262,377.589907,0,0.001319
n889,doc/Type/X/Attribute/Package.pod6,,95,88,183,135,0.368252,0.591716,112,176,288,7,0.323616,0.448914,202.909249,0,0.001188
n890,doc/Type/X/Attribute/Undeclared.pod6,,23,81,104,135,0.472834,0.271755,28,137,165,8,0.283543,0.385798,5.01486,0,0.000765
n891,doc/Type/X/Augment/NoSuchType.pod6,,97,86,183,135,0.368252,0.591716,117,171,288,7,0.323616,0.448914,202.909249,0,0.001188
n892,doc/Type/X/Caller/NotDynamic.pod6,,28,76,104,135,0.472834,0.271755,36,129,165,8,0.283543,0.385798,5.01486,0,0.000765
n893,doc/Type/X/Composition/NotComposable.pod6,,104,79,183,135,0.368252,0.591716,131,157,288,7,0.323616,0.448914,202.909249,0,0.001188
n894,doc/Type/X/Constructor/Positional.pod6,,14,66,80,135,0.493987,0.185966,14,67,81,8,0.280281,0.370291,0.757651,0,0.000629
n895,doc/Type/X/ControlFlow/Return.pod6,,14,65,79,135,0.5,0.18121,14,65,79,8,0.27432,0.358071,0,0,0.000624
n896,doc/Type/X/DateTime/TimezoneClash.pod6,,76,70,146,135,0.364242,0.44611,95,128,223,7,0.319606,0.428295,189.133994,0,0.000992
n897,doc/Type/X/Declaration/Scope.pod6,,132,75,207,135,0.344777,0.685782,190,156,346,7,0.326995,0.463262,377.589907,0,0.001319
n898,doc/Type/X/Declaration/Scope/Multi.pod6,,36,68,104,135,0.472834,0.271755,48,117,165,8,0.283543,0.385798,5.01486,0,0.000765
n899,doc/Type/X/Export/NameClash.pod6,,39,65,104,135,0.472834,0.271755,53,112,165,8,0.283543,0.385798,5.01486,0,0.000765
n900,doc/Type/X/IO/DoesNotExist.pod6,,45,59,104,135,0.472834,0.271755,61,104,165,8,0.283543,0.385798,5.01486,0,0.000765
n901,doc/Type/X/IO/Mkdir.pod6,,47,57,104,135,0.472834,0.271755,65,100,165,8,0.283543,0.385798,5.01486,0,0.000765
n902,doc/Type/X/IO/Move.pod6,,48,56,104,135,0.472834,0.271755,67,98,165,8,0.283543,0.385798,5.01486,0,0.000765
n903,doc/Type/X/IO/Rename.pod6,,49,55,104,135,0.472834,0.271755,69,96,165,8,0.283543,0.385798,5.01486,0,0.000765
n904,doc/Type/X/IO/Symlink.pod6,,51,53,104,135,0.472834,0.271755,73,92,165,8,0.283543,0.385798,5.01486,0,0.000765
n905,doc/Type/X/Inheritance/Unsupported.pod6,,54,50,104,135,0.472834,0.271755,78,87,165,8,0.283543,0.385798,5.01486,0,0.000765
n906,doc/Type/X/Method/InvalidQualifier.pod6,,116,54,170,135,0.375879,0.553758,127,75,202,7,0.321599,0.441103,178.412325,0,0.001113
n907,doc/Type/X/Method/NotFound.pod6,,129,54,183,135,0.368252,0.591716,177,111,288,7,0.323616,0.448914,202.909249,0,0.001188
n908,doc/Type/X/Method/Private/Permission.pod6,,130,53,183,135,0.368252,0.591716,180,108,288,7,0.323616,0.448914,202.909249,0,0.001188
n909,doc/Type/X/Method/Private/Unqualified.pod6,,131,52,183,135,0.368252,0.591716,183,105,288,7,0.323616,0.448914,202.909249,0,0.001188
n910,doc/Type/X/NoDispatcher.pod6,,122,48,170,135,0.375879,0.553758,137,65,202,7,0.321599,0.441103,178.412325,0,0.001113
n911,doc/Type/X/Numeric/Real.pod6,,123,47,170,135,0.375879,0.553758,139,63,202,7,0.321599,0.441103,178.412325,0,0.001113
n912,doc/Type/X/OutOfRange.pod6,,126,44,170,135,0.375879,0.553758,144,58,202,7,0.321599,0.441103,178.412325,0,0.001113
n913,doc/Type/X/Package/Stubbed.pod6,,139,44,183,135,0.368252,0.591716,199,89,288,7,0.323616,0.448914,202.909249,0,0.001188
n914,doc/Type/X/Parameter/Default.pod6,,66,38,104,135,0.472834,0.271755,97,68,165,8,0.283543,0.385798,5.01486,0,0.000765
n915,doc/Type/X/Parameter/Placeholder.pod6,,68,36,104,135,0.472834,0.271755,101,64,165,8,0.283543,0.385798,5.01486,0,0.000765
n916,doc/Type/X/Parameter/Twigil.pod6,,69,35,104,135,0.472834,0.271755,103,62,165,8,0.283543,0.385798,5.01486,0,0.000765
n917,doc/Type/X/Parameter/WrongOrder.pod6,,70,34,104,135,0.472834,0.271755,105,60,165,8,0.283543,0.385798,5.01486,0,0.000765
n918,doc/Type/X/Phaser/Multiple.pod6,,71,33,104,135,0.472834,0.271755,107,58,165,8,0.283543,0.385798,5.01486,0,0.000765
n919,doc/Type/X/Phaser/PrePost.pod6,,170,37,207,135,0.344777,0.685782,268,78,346,7,0.326995,0.463262,377.589907,0,0.001319
n920,doc/Type/X/Redeclaration.pod6,,78,26,104,135,0.472834,0.271755,118,47,165,8,0.283543,0.385798,5.01486,0,0.000765
n921,doc/Type/X/Role/Initialization.pod6,,56,23,79,135,0.5,0.18121,56,23,79,8,0.27432,0.358071,0,0,0.000624
n922,doc/Type/X/Signature/NameClash.pod6,,157,26,183,135,0.368252,0.591716,232,56,288,7,0.323616,0.448914,202.909249,0,0.001188
n923,doc/Type/X/Signature/Placeholder.pod6,,182,25,207,135,0.344777,0.685782,290,56,346,7,0.326995,0.463262,377.589907,0,0.001319
n924,doc/Type/X/Str/Numeric.pod6,,147,23,170,135,0.375879,0.553758,172,30,202,7,0.321599,0.441103,178.412325,0,0.001113
n925,doc/Type/X/Syntax/Augment/WithoutMonkeyTyping.pod6,,83,21,104,135,0.472834,0.271755,126,39,165,8,0.283543,0.385798,5.01486,0,0.000765
n926,doc/Type/X/Syntax/Comment/Embedded.pod6,,126,20,146,135,0.364242,0.44611,184,39,223,7,0.319606,0.428295,189.133994,0,0.000992
n927,doc/Type/X/Syntax/InfixInTermPosition.pod6,,163,20,183,135,0.368252,0.591716,245,43,288,7,0.323616,0.448914,202.909249,0,0.001188
n928,doc/Type/X/Syntax/Missing.pod6,,165,18,183,135,0.368252,0.591716,251,37,288,7,0.323616,0.448914,202.909249,0,0.001188
n929,doc/Type/X/Syntax/NoSelf.pod6,,89,15,104,135,0.472834,0.271755,137,28,165,8,0.283543,0.385798,5.01486,0,0.000765
n930,doc/Type/X/Syntax/Regex/SolitaryQuantifier.pod6,,92,12,104,135,0.472834,0.271755,142,23,165,8,0.283543,0.385798,5.01486,0,0.000765
n931,doc/Type/X/Syntax/Reserved.pod6,,171,12,183,135,0.368252,0.591716,263,25,288,7,0.323616,0.448914,202.909249,0,0.001188
n932,doc/Type/X/Syntax/Self/WithoutObject.pod6,,94,10,104,135,0.472834,0.271755,146,19,165,8,0.283543,0.385798,5.01486,0,0.000765
n933,doc/Type/X/Syntax/Signature/InvocantMarker.pod6,,95,9,104,135,0.472834,0.271755,148,17,165,8,0.283543,0.385798,5.01486,0,0.000765
n934,doc/Type/X/Syntax/Term/MissingInitializer.pod6,,96,8,104,135,0.472834,0.271755,150,15,165,8,0.283543,0.385798,5.01486,0,0.000765
n935,doc/Type/X/Syntax/UnlessElse.pod6,,97,7,104,135,0.472834,0.271755,152,13,165,8,0.283543,0.385798,5.01486,0,0.000765
n936,doc/Type/X/Syntax/Variable/Match.pod6,,98,6,104,135,0.472834,0.271755,154,11,165,8,0.283543,0.385798,5.01486,0,0.000765
n937,doc/Type/X/Syntax/Variable/Numeric.pod6,,99,5,104,135,0.472834,0.271755,156,9,165,8,0.283543,0.385798,5.01486,0,0.000765
n938,doc/Type/X/Syntax/Variable/Twigil.pod6,,178,5,183,135,0.368252,0.591716,278,10,288,7,0.323616,0.448914,202.909249,0,0.001188
n939,doc/Type/X/Temporal/InvalidFormat.pod6,,144,3,147,135,0.363526,0.450682,219,5,224,7,0.319723,0.428865,190.178151,0,0.000997
n940,doc/Type/X/TypeCheck/Return.pod6,,168,2,170,135,0.375879,0.553758,199,3,202,7,0.321599,0.441103,178.412325,0,0.001113
n941,doc/Type/X/TypeCheck/Splice.pod6,,182,1,183,135,0.368252,0.591716,286,2,288,7,0.323616,0.448914,202.909249,0,0.001188
n942,doc/Type/X/Undeclared.pod6,,104,0,104,135,0.472834,0.271755,165,0,165,8,0.283543,0.385798,5.01486,0,0.000765
n943,doc/Type/IO/Handle.pod6,,54,175,229,136,0.3169,0.760088,131,325,456,7,0.358838,0.498287,2504.826507,0,0.001572
n944,doc/Type/IO/Notification.pod6,,37,95,132,135,0.364273,0.416976,40,114,154,7,0.332323,0.430974,299.246291,0,0.00091
n945,doc/Type/IO/Spec.pod6,,32,100,132,136,0.450093,0.489975,37,124,161,7,0.32302,0.425425,185.978766,0,0.000946
n946,doc/Type/IO/Spec/QNX.pod6,,34,98,132,136,0.450093,0.489975,56,115,171,7,0.32302,0.425425,185.978766,0,0.000946
n947,doc/Type/IO/Spec/Unix.pod6,,54,105,159,136,0.407133,0.588576,106,149,255,7,0.326508,0.441198,235.760188,0,0.001095
n948,doc/Type/IO/Spec/Win32.pod6,,56,105,161,136,0.400776,0.592545,130,126,256,7,0.340583,0.452278,370.860312,0,0.00114
n949,doc/Type/IO/Special.pod6,,57,144,201,135,0.350796,0.676865,87,191,278,7,0.326265,0.459841,412.713794,0,0.001323
n950,doc/Type/Backtrace/Frame.pod6,,4,145,149,136,0.430483,0.564787,8,211,219,7,0.319141,0.429131,123.856485,0,0.000989
n951,doc/Type/Metamodel/MROBasedMethodDispatch.pod6,,2,3,5,136,0.5,0.015743,2,3,5,8,0.264715,0.312955,0,0,0.000186
n952,doc/Type/Dateish.pod6,,85,154,239,136,0.382757,0.910597,131,278,409,7,0.347052,0.492833,140.602011,0,0.001444
n953,doc/Language/io.pod6,,24,177,201,136,0.417338,0.779032,77,284,361,7,0.346503,0.475748,315.592216,0,0.001311
n954,doc/Type/Failure.pod6,,90,148,238,136,0.384374,0.90825,132,262,394,7,0.346915,0.492263,137.15635,0,0.001439
n955,doc/Type/Parameter.pod6,,146,101,247,136,0.369705,0.927264,298,190,488,7,0.348154,0.497394,187.231974,0,0.001494
n956,doc/Type/WhateverCode.pod6,,174,5,179,136,0.482644,0.729439,283,7,290,7,0.338741,0.458245,12.891084,0,0.001109
n957,util/list-missing-methods.p6,,13,0,13,136,0.423077,0.048576,13,0,13,8,0.271097,0.323978,7.938298,0,0.000305
n958,doc/Type/Pod/Item.pod6,,57,66,123,136,0.5,0.477599,60,68,128,7,0.31615,0.414307,0,0,0.000821
n959,doc/Type/FatRat.pod6,,90,81,171,136,0.5,0.704473,90,86,176,7,0.337697,0.453684,0,0,0.001063
n960,doc/Type/NumStr.pod6,,126,53,179,136,0.482644,0.729439,212,111,323,7,0.338741,0.458245,12.891084,0,0.001109
n961,doc/Type/Uni.pod6,,184,51,235,136,0.389162,0.901923,245,54,299,7,0.346503,0.490552,122.586165,0,0.001421
n962,util/ignored-methods.txt,,1,1,2,136,0,0.005375,1,1,2,8,0.27236,0.323351,0.172009,0,0.000183
n963,doc/Type/IntStr.pod6,,99,82,181,136,0.47299,0.730383,164,166,330,7,0.339003,0.459385,60.225561,0,0.00114
n964,doc/Type/Real.pod6,,164,83,247,136,0.367977,0.924935,313,136,449,7,0.348154,0.497394,248.512619,0,0.001513
n965,doc/Type/Semaphore.pod6,,164,73,237,136,0.383251,0.902867,222,89,311,7,0.346777,0.491692,196.107131,0,0.001452
n966,doc/Type/Iterator.pod6,,112,133,245,136,0.373402,0.92399,217,245,462,7,0.347878,0.496253,161.970504,0,0.001481
n967,doc/Type/Seq.pod6,,167,75,242,136,0.377919,0.917663,280,100,380,7,0.347464,0.494543,144.284661,0,0.001463
n968,xt/trailing-whitespace.t,,18,2,20,144,0.384211,0.011948,53,3,56,6,0.335117,0.379228,228.721763,0,0.000861
n969,doc/Type/UInt.pod6,,170,21,191,136,0.450648,0.767203,232,24,256,7,0.340583,0.465467,32.5529,0,0.001178
n970,html/images/External-link-04-bold-12x12.svg,,1,2,3,95,0.333333,0.00022,1,2,3,6,0.264077,0.273755,2.213932,0,0.000428
n971,doc/Type/WrapHandle.pod6,,193,45,238,136,0.384374,0.90825,335,45,380,7,0.346915,0.492263,137.15635,0,0.001439
n972,xt/.aspell.pws,,0,1,1,144,0,0.000095,0,1,1,7,0.237605,0.24899,0,0,0.000203
n973,xt/aspell.t,,12,10,22,144,0.324675,0.004221,23,36,59,6,0.311545,0.340764,994.08747,0,0.00115
n974,xt/code.pws,,44,2,46,144,0.24058,0.124296,49,30,79,6,0.383975,0.429057,6583.776698,0,0.000838
n975,xt/doc,,3,1,4,144,0.5,0.001723,3,1,4,6,0.299011,0.3168,0,0,0.000296
n976,xt/words.pws,,69,0,69,144,0.184143,0.154225,117,0,117,6,0.389259,0.443406,12903.984341,0,0.001629
n977,doc/Type/Regex.pod6,,163,75,238,136,0.384374,0.90825,292,115,407,7,0.346915,0.492263,137.15635,0,0.001439
n978,doc/Language/grammar_tutorial.pod6,,20,154,174,136,0.486944,0.707785,47,204,251,7,0.342578,0.459974,84.748786,0,0.001105
n979,util/xt-recent-aspell.p6,,0,0,0,139,0,0,0,0,0,0,0,0,0,0,0
n980,doc/Type/X/Proc/Unsuccessful.pod6,,111,14,125,136,0.488258,0.481473,119,14,133,6,0.379983,0.459768,26441.004262,0,0.000873
n981,doc/Language/community.pod6,,9,163,172,136,0.4966,0.706258,16,202,218,7,0.337827,0.454254,1.314558,0,0.00107
n982,doc/Type/Mixy.pod6,,118,61,179,136,0.482644,0.729439,176,101,277,7,0.338741,0.458245,12.891084,0,0.001109
n983,t/return-type.t,,0,0,0,140,0,0,0,0,0,0,0,0,0,0,0
n984,doc/Type/Metamodel/Finalization.pod6,,40,83,123,136,0.5,0.477599,40,83,123,7,0.31615,0.414307,0,0,0.000821
n985,doc/Type/Order.pod6,,139,96,235,136,0.389162,0.901923,196,132,328,7,0.346503,0.490552,122.586165,0,0.001421
n986,doc/Type/Pod/Block.pod6,,54,69,123,136,0.5,0.477599,54,69,123,7,0.31615,0.414307,0,0,0.000821
n987,doc/Type/Pod/Block/Code.pod6,,55,68,123,136,0.5,0.477599,55,68,123,7,0.31615,0.414307,0,0,0.000821
n988,doc/Type/Pod/Block/Named.pod6,,56,67,123,136,0.5,0.477599,56,67,123,7,0.31615,0.414307,0,0,0.000821
n989,doc/Type/PositionalBindFailover.pod6,,151,87,238,136,0.384374,0.90825,236,136,372,7,0.346915,0.492263,137.15635,0,0.001439
n990,doc/Type/X/OS.pod6,,101,22,123,136,0.5,0.477599,101,22,123,7,0.31615,0.414307,0,0,0.000821
n991,doc/Type/X/Syntax/Number/RadixOutOfRange.pod6,,117,6,123,136,0.5,0.477599,117,6,123,7,0.31615,0.414307,0,0,0.000821
n992,doc/Type/X/TypeCheck.pod6,,121,2,123,136,0.5,0.477599,121,2,123,7,0.31615,0.414307,0,0,0.000821
n993,xt/return-type.t,,14,4,18,144,0.460784,0.003337,41,13,54,6,0.308044,0.335044,18.628495,0,0.000846
n994,html/js/jquery-3.1.1.min.js,,0,1,1,95,0,0.000081,0,2,2,6,0.252665,0.261859,0,0,0.00024
n995,xt/space-after-commma.t,,0,0,0,141,0,0,0,0,0,0,0,0,0,0,0
n996,html/js/levenshtein.js,,0,2,2,95,0.5,0.00015,0,2,2,6,0.257714,0.266553,0,0,0.000322
n997,highlights/highlight-folder.coffee,,0,1,1,95,0,0.000334,0,1,1,6,0.320893,0.337134,0,0,0.000198
n998,highlights/highlight-file.coffee,,1,5,6,95,0.5,0.000681,1,5,6,6,0.321953,0.34065,0,0,0.000615
n999,highlights/highlight-filename-from-stdin.coffee,,2,4,6,95,0.5,0.000681,3,5,8,6,0.321953,0.34065,0,0,0.000615
n1000,highlights/package.json,,3,3,6,95,0.5,0.000681,4,3,7,6,0.321953,0.34065,0,0,0.000615
n1001,html/css/pygments.css.bak,,5,1,6,95,0.5,0.000681,5,1,6,6,0.321953,0.34065,0,0,0.000615
n1002,html/js/sift4-common.js,,1,0,1,136,0,0.003819,1,0,1,8,0.261947,0.300945,0,0,0.000164
n1003,html/css/highlights.css,,0,2,2,95,0.5,0.000143,0,5,5,6,0.251794,0.261992,0,0,0.000332
n1004,util/compile-sass.sh,,2,0,2,95,0.5,0.000433,2,0,2,6,0.321363,0.338179,0,0,0.000263
n1005,assets/sass/_jquery-ui.scss,,0,2,2,95,0.5,0.000161,0,2,2,6,0.264157,0.273565,0,0,0.000318
n1006,assets/sass/_highlights.scss,,0,2,2,95,0.5,0.000161,0,5,5,6,0.264157,0.273565,0,0,0.000318
n1007,util/trigger-rebuild.txt,,0,0,0,142,0,0,0,0,0,0,0,0,0,0,0
n1008,type-groups.json,,0,0,0,143,0,0,0,0,0,0,0,0,0,0,0
n1009,doc/Type/Associative.pod6,,61,110,171,136,0.5,0.704473,61,110,171,7,0.337697,0.453684,0,0,0.001063
n1010,doc/Type/Cursor.pod6,,81,90,171,136,0.5,0.704473,81,90,171,7,0.337697,0.453684,0,0,0.001063
n1011,doc/Language/unicode.pod6,,51,124,175,136,0.484959,0.711664,143,134,277,7,0.342712,0.460545,85.329753,0,0.001111
n1012,doc/Type/Metamodel/Naming.pod6,,41,37,78,136,0.5,0.342093,41,37,78,8,0.28082,0.370576,0,0,0.000568
n1013,doc/Type/IO/ArgFiles.pod6,,9,10,19,136,0.339181,0.059523,9,10,19,6,0.366332,0.401691,1229.905737,0,0.000348
n1014,xt/examples-compilation.t,,37,6,43,144,0.19103,0.081168,63,23,86,6,0.341777,0.395876,2719.178885,0,0.001202
n1015,doc/Language/from-haskell.pod6,,0,0,0,145,0,0,0,0,0,0,0,0,0,0,0
n1016,doc/Language/haskell-to-p6.pod6,,22,171,193,136,0.443842,0.769462,55,267,322,7,0.34514,0.470807,113.038032,0,0.001208
n1017,doc/Language/py-nutshell.pod6,,39,136,175,136,0.483284,0.710354,50,167,217,7,0.342846,0.460735,142.905141,0,0.001128
n1018,doc/Language/pod.pod6,,38,137,175,136,0.480361,0.707125,44,140,184,7,0.35094,0.46731,320.466411,0,0.001151
n1019,doc/Type/IO/Path/Cygwin.pod6,,4,10,14,144,0.5,0.032805,5,16,21,7,0.308044,0.355489,0,0,0.000301
n1020,doc/Type/IO/Path/QNX.pod6,,5,9,14,144,0.5,0.032805,8,13,21,7,0.308044,0.355489,0,0,0.000301
n1021,doc/Type/IO/Path/Unix.pod6,,6,8,14,144,0.5,0.032805,11,10,21,7,0.308044,0.355489,0,0,0.000301
n1022,doc/Type/IO/Path/Win32.pod6,,7,7,14,144,0.5,0.032805,14,7,21,7,0.308044,0.355489,0,0,0.000301
n1023,doc/Type/IO/Socket.pod6,,2,1,3,136,0.5,0.012159,2,1,3,8,0.273039,0.325156,0,0,0.000175
n1024,doc/Language/io-guide.pod6,,23,177,200,136,0.419673,0.777248,30,217,247,7,0.346367,0.475178,311.599342,0,0.001305
n1025,META6.json,,0,2,2,144,0,0.000159,0,2,2,5,0.270679,0.280559,20.429533,0,0.000268
n1026,doc/Language/modules-core.pod6,,29,145,174,136,0.485748,0.706963,30,148,178,7,0.353914,0.469781,375.803288,0,0.001138
n1027,doc/Type/IO/CatHandle.pod6,,26,37,63,136,0.445469,0.236868,26,39,65,6,0.374947,0.428867,8546.557326,0,0.000575
n1028,xt/duplicates.t,,12,7,19,144,0.412281,0.007417,27,28,55,6,0.325297,0.363835,82.731905,0,0.000853
n1029,xt/perl-nbsp.t,,13,5,18,144,0.460784,0.003337,36,18,54,6,0.308044,0.335044,18.628495,0,0.000846
n1030,doc/Type/Encoding.pod6,,87,84,171,136,0.5,0.704473,87,84,171,7,0.337697,0.453684,0,0,0.001063
n1031,doc/Type/Pod/Block/Comment.pod6,,0,0,0,146,0,0,0,0,0,0,0,0,0,0,0
n1032,doc/Type/Pod/Heading.pod6,,0,0,0,147,0,0,0,0,0,0,0,0,0,0,0
n1033,doc/Type/Pod/Block/Table.pod6,,0,0,0,148,0,0,0,0,0,0,0,0,0,0,0
n1034,xt/space-after-comma.t,,15,3,18,144,0.460784,0.003337,46,8,54,6,0.308044,0.335044,18.628495,0,0.000846
n1035,doc/Type/Buf.pod6,,70,101,171,136,0.5,0.704473,81,107,188,7,0.337697,0.453684,0,0,0.001063
n1036,doc/Type/PseudoStash.pod6,,130,42,172,136,0.495172,0.705319,130,42,172,7,0.342177,0.458644,57.265978,0,0.001083
n1037,t/pod-valid.t,,5,13,18,144,0.460784,0.003337,5,49,54,6,0.308044,0.335044,18.628495,0,0.000846
n1038,EXAMPLES.md,,1,2,3,144,0.333333,0.001817,1,2,3,7,0.299829,0.321263,0.190367,0,0.000226
n1039,doc/Type/atomicint.pod6,,169,5,174,136,0.488207,0.70988,202,5,207,7,0.342578,0.459974,83.13315,0,0.001105
n1040,util/xt-recent-aspell.sh,,0,0,0,149,0,0,0,0,0,0,0,0,0,0,0
n1041,t/meta.t,,2,15,17,144,0.441176,0.002664,2,15,17,6,0.299113,0.323717,338.53479,0,0.000885
n1042,doc/Type/utf8.pod6,,171,0,171,136,0.5,0.704473,171,0,171,7,0.337697,0.453684,0,0,0.001063
n1043,doc/Language/enumeration.pod6,,14,157,171,136,0.5,0.704473,14,158,172,7,0.337697,0.453684,0,0,0.001063
n1044,doc/Programs/02-reading-docs.pod6,,57,114,171,136,0.5,0.704473,57,114,171,7,0.337697,0.453684,0,0,0.001063
n1045,util/xt-recent.sh,,4,8,12,144,0.5,0.002838,4,8,12,7,0.301582,0.327914,0,0,0.000591
n1046,doc/Language/unicode_ascii.pod6,,52,119,171,136,0.5,0.704473,56,119,175,7,0.337697,0.453684,0,0,0.001063
n1047,doc/Type/Pod/Block/Declarator.pod6,,1,0,1,136,0,0.005088,1,0,1,8,0.270512,0.320994,0,0,0.000164
n1048,doc/Type/Supplier/Preserving.pod6,,0,0,0,150,0,0,0,0,0,0,0,0,0,0,0
n1049,doc/Type/Scheduler.pod6,,140,31,171,136,0.5,0.704473,141,32,173,7,0.337697,0.453684,0,0,0.001063
n1050,xt/type-graph.t,,15,1,16,144,0.5,0.002611,15,1,16,6,0.299011,0.323147,0,0,0.000774
n1051,Dockerfile,,2,0,2,144,0,0.000706,2,0,2,7,0.291847,0.308758,876,0,0.000504
n1052,.dockerignore,,0,1,1,144,0,0.000056,0,1,1,8,0.225973,0.233974,0,0,0.000372
n1053,doc/Type/Metamodel/EnumHOW.pod6,,0,0,0,151,0,0,0,0,0,0,0,0,0,0,0
n1054,doc/Type/Telemetry.pod6,,157,17,174,136,0.483988,0.705575,157,21,178,7,0.34045,0.457029,321.424726,0,0.00117
n1055,doc/Type/Telemetry/Period.pod6,,157,14,171,136,0.5,0.704473,160,15,175,7,0.337697,0.453684,0,0,0.001063
n1056,doc/Type/snapper.pod6,,170,1,171,136,0.5,0.704473,172,1,173,7,0.337697,0.453684,0,0,0.001063
n1057,doc/Type/Kernel.pod6,,100,71,171,136,0.5,0.704473,100,71,171,7,0.337697,0.453684,0,0,0.001063
n1058,doc/Type/Distro.pod6,,85,86,171,136,0.5,0.704473,85,86,171,7,0.337697,0.453684,0,0,0.001063
n1059,doc/Type/VM.pod6,,162,9,171,136,0.5,0.704473,162,9,171,7,0.337697,0.453684,0,0,0.001063
n1060,doc/Type/Perl.pod6,,124,47,171,136,0.5,0.704473,124,47,171,7,0.337697,0.453684,0,0,0.001063
n1061,doc/404.pod6,,0,171,171,136,0.5,0.704473,0,171,171,7,0.337697,0.453684,0,0,0.001063
n1062,doc/Type/AST.pod6,,58,113,171,136,0.5,0.704473,58,113,171,7,0.337697,0.453684,0,0,0.001063
n1063,doc/Type/Duration.pod6,,86,85,171,136,0.5,0.704473,86,85,171,7,0.337697,0.453684,0,0,0.001063
n1064,doc/Type/Macro.pod6,,104,67,171,136,0.5,0.704473,104,67,171,7,0.337697,0.453684,0,0,0.001063
n1065,doc/Type/ObjAt.pod6,,120,51,171,136,0.5,0.704473,120,51,171,7,0.337697,0.453684,0,0,0.001063
n1066,doc/Type/Positional.pod6,,125,46,171,136,0.5,0.704473,125,46,171,7,0.337697,0.453684,0,0,0.001063
n1067,doc/Type/QuantHash.pod6,,131,40,171,136,0.5,0.704473,131,40,171,7,0.337697,0.453684,0,0,0.001063
n1068,doc/Type/Stringy.pod6,,150,21,171,136,0.5,0.704473,150,21,171,7,0.337697,0.453684,0,0,0.001063
n1069,doc/Type/nativeInt.pod6,,169,2,171,136,0.5,0.704473,169,2,171,7,0.337697,0.453684,0,0,0.001063
n1070,html/images/pencil.svg,,2,1,3,95,0.333333,0.00047,2,1,3,6,0.322071,0.339795,128.162993,0,0.000395
n1071,doc/Type/Telemetry/snapper.pod6,,0,0,0,152,0,0,0,0,0,0,0,0,0,0,0
n1072,doc/Type/Telemetry/Instrument/Usage.pod6,,0,0,0,153,0,0,0,0,0,0,0,0,0,0,0
n1073,doc/Type/Telemetry/Instrument/Threadpool.pod6,,1,1,2,144,0.5,0.004233,1,1,2,7,0.292333,0.322821,0,0,0.000179
n1074,doc/Type/Telemetry/Instrument/Thread.pod6,,1,1,2,144,0.5,0.000908,1,1,2,7,0.280371,0.298572,0,0,0.00031
n1075,doc/Type/Lock/Async.pod6,,0,2,2,144,0.5,0.000908,0,2,2,7,0.280371,0.298572,0,0,0.00031
n1076,doc/Type/Telemetry/Sampler.pod6,,0,0,0,154,0,0,0,0,0,0,0,0,0,0,0
n1077,xt/double-dots.t,,4,0,4,136,0.5,0.015703,4,0,4,7,0.310773,0.350928,0,0,0.000182
n1078,doc/Type/HyperWhatever.pod6,,0,0,0,155,0,0,0,0,0,0,0,0,0,0,0
